# # # # # # # # # # # # # # # # # # # # # # # # # # # # # # # # # # # # # # # # # # # # # # # # # # # # # # # # # # # # # # # # # # # # # # # # # # # # # # # # # # # # # # # # # # # # # # # # # # # # # 
#   # # #                             # # # #                       # # # #     #                                                                       # # #   # #       # #                         # # 
#   # # #                             # # # #                       # # # #     #                                                                       # # #   #   # # # # #                     #     # 
#                                                                               #                                                                       # # #   #   # # # # #               # # # # # # # 
#                                                                               #                                                                       # # #   #   # # # # #               # # # # # # # 
#                                                                               #                                       # #                                     #   # # # # #               # # # # #   # 
#                                                                               #                                       # #                                     #                           # # #       # 
#                                                                               #                               # #   # # #     # # # # #     # # #             #                                       # 
#                                                                                                 # # # # # # # # # # # # # # # # # # # # # # # # #                                                     # 
#                                                                                                 # # # # # # # # # # # # # # # # # # # # # # # # #                                                     # 
#                                                                                                 # # # # # # # # # # # # # # # # # # # # # # # # #                                                     # 
#                                                                                                 # # # # # # # # # # # #   # # # # #   # # # # # #                                                     # 
#                                                                                                                                                                                                       # 
#                                                                               #                                                                               #                                       # 
#                                                                               #                                                                               #                                       # 
#                                                                               #                                                                               #                               # # # # # 
#                                                                               #                                                                               #                               # # # # # 
#                                                                               #                                                                               # # #                       # # # # # # # 
#   # # #                             # # # #                       # # # #     #                                                                               # # # # # # #             # # # # # # # # 
#   # # #                             # # # #                       # # # #     #                                                                               # #   # # # #               # # #     # # 
# # # # # # # #           # # # # # # # # # # # # # # # # # # # # # # # # # # # # # # # # # # # # # # # # # # # # # # # # # # # # # # #           # # # # # # # # # # # # # # #           # # # # # # # # 
#                                       #                                       # # #                         # # #     #                                       #                                       # 
#                                       #                                       # # #                         # # #     #                                       #                                       # 
#                                       #                                       # # #                         # # #     #                                       #                                       # 
#                                       #                                       # # #                 # #     # # # # # #                                       #                                       # 
#                                       #                                       # # #                 # #     # # # # # #                                       #                                       # 
#                                       #                                       # # #   # # # #       # #     # # # # # #                                       #                                       # 
#                                       #                                       # # #   # # # #               # # # # # #                 # # #                 #                                       # 
#                                       #                                       #       # # # #                                           # # #                                                         # 
#                 # # #                 #               # # # #                 #       # # # #                                           # # #                                   # # #                 # 
#                 # # #                 #               # # # #                 #       # # # #               # # #                       # # #                                   # # #                 # 
#                 # # #                 #               # # # #                 #                   # # #     # # #                       # # #                                   # # #                 # 
#                                       #               # # # #                 #         # # # #   # # #     # # #                       # # #                                                         # 
#                                       #               # # # #                 # # #     # # # #             # # #     #                 # # #                 #                                       # 
#                                       #               # # # #                 # # #     # # # #                       #                                       #                                       # 
#                                       #               # # # #                 # # #     # # # #         # # # #       #                                       #                                       # 
#                                       #             # # # # #                 # # #     # # # #         # # # #       #                                       #                                       # 
#                                       #             # # # # #                 # # #                     # # # #       #                                       #                                       # 
#                                       #               # # # #                 # # #     # # #       # # # # # #       #                                       #                                       # 
#                                       #             # # # # #                 # # #     # # #       # # # # #         #                                       #                                       # 
# # # # # # # #           # # # # # # # #         # # # # # # #                 # # # # # # # #           # # # # # # # # # # # # # # # # # # # # # # # # # # # # # # # # # # #           # # # # # # # # 
# #                                   # #         # # # # # #                   #                                       #                           # # #   # # #                                       # 
#                                       #               # # # #                 # # #                               # # #                                   # # #                                       # 
#                           # # # #     #               # # # #                 # # #                               # # #                                       #                                       # 
#                           # # # #     #             # # # # #                 # # #                               # # #   # # #                 # # #     # # #                                       # 
#                                       #             # # # # #                 #                                       #   # # #             # # # # #     # # #                                       # 
#     # # #       # # #         # #     #             # # # # #                 #                                       #   # # #             # # # # #         #                                       # 
#     # # #       # # #         # #     #             # # # #                   #                                       #           # #   # # # # #             #                 # # #                 # 
#     # # #       # # #         # #                   # # # # #                 #                                       #           # # # # # #     # #                           # # #                 # 
#       # #                   # #                       # # # #                 #                                       #             # # # # #   # # #                           # # #                 # 
#       # #                   # #                       # # # #                 #                                       #             # # # # #   # # #                           # # #                 # 
#       # #                   # #                     # # # # #                 #                                       #             # # # # #   # # #                           # # #                 # 
#     # # #       # # #         # #                   # # # # #                 #                                       #             # # # # #   # # #                           # # #                 # 
#     # # #       # # #         # #     #             # # # # #                 #                                       #             # # # # #     # #         #                 # # #                 # 
#     # # #       # # #         # #     #                                       #                                       #                                   # # #                                       # 
# # # # # #                             #                                       #                                       #                         # # #     # # #                                       # 
# # # # # #                             # # # # #                               #                                       # # # # # #               # # #         #                                       # 
# # # # # #                             # # # # #                               #                                       # # # # # #               # # #         #                                       # 
# # # # # #                             # # # # #                               #                                       # # # # # #                             #                                       # 
# # # # # #                           # #                                       # # #                               # # # # # # # #                             #                                       # 
# # # # # # # #           # # # # # # # # # # # # # # #           # # # # # # # # # #                               # # # # # # # # # #           # # # # # # # # # # # # # # #           # # # # # # # # 
#                                 # # # # # # # # # #               # # # # # # # # #                               # # #                                       #                                       # 
#                                 # # # # # # # # # #               # # # # # # # # #                               # # #                                       #                                       # 
#                                 # # # # # # # # # #               # # # # # # #                                       #                                       #                                       # 
# #                                     # # # # # # #               # # # # # # #                                       #                                       #                                       # 
# #                                   # # # # # # # #               # # # # # # #                                       #                                       #                                       # 
#                                     # # # # # # # #               # # # # # # #                                       #                                       #                                       # 
#                                       #                                       #                                       #                                       #                                       # 
#                 # # # #               #                                       #                                       #                                       #                                       # 
#                 # # # # #             #                                       #                                       #                 # # #                 #                                       # 
#                 # # # # #             #                                       #                                       #                 # # #                 #                                       # 
#                 # # # #               #                                       #                                       #                 # # #                 #                                       # 
#                 # # # #               #                                       #                                       #                                       #                                       # 
#                                       #                                       #                                       #                                       #                                       # 
#                                     # # # # # # # #                           # # #                               # # #                                       #                                       # 
# #                                   # # # # # # # #                           # # #                               # # #                                       #                                       # 
# #                                   # # # # # # # #                           # # #                               # # #                                       #                                       # 
#                                     # # # # # # # #                           # # #                               # # #                                       #                                       # 
#                                       # # # # # # #                           #                                       #                                       #                                       # 
#                                       # # # # # # #                           #                                       #                                       #                                       # 
# # # # # # # #           # # # # # # # # # # # # # # #           # # # # # # # # # # # # # # #           # # # # # # # # # # # # # # # # # # # # # # # # # # # # # # # # # # #           # # # # # # # # 
# # #                         # # #     # # #                         # # #     #                                       #                           # # #   # # #                           # # #   # # # 
# # #                         # # #     # # #                         # # #     #                                       #                                   # # #                                   # # # 
# # #                         # # #     # # #                         # # #     #                                       #                                       #                                       # 
# # #                 # #     # # # # # # # #                 # #     # # # # # #                                       #   # # #                 # # #     # # #   # # #                 # # #     # # # 
# # #                 # #     # # # # # # # #                 # #     # # # # # #                                       #   # # #             # # # # #     # # #   # # #             # # # # #     # # # 
# # #   # # # #       # #     # # # # # # # #   # # # #       # #     # # # # # #                                       #   # # #             # # # # #         #   # # #             # # # # #         # 
# # #   # # # #               # # # # # # # #   # # # #               # # # # # #                                       #           # #   # # # # #             #           # #   # # # # #             # 
#       # # # #                                 # # # #                         #                                       #           # # # # # #     # #                     # # # # # #     # #         # 
#       # # # #                                 # # # #                         #                 # # #                 #             # # # # #   # # #                       # # # # #   # # #         # 
#       # # # #               # # #             # # # #               # # #     #                 # # #                 #             # # # # #   # # #                       # # # # #   # # #         # 
#                   # # #     # # #                         # # #     # # #     #                 # # #                 #             # # # # #   # # #                       # # # # #   # # #         # 
#         # # # #   # # #     # # #               # # # #   # # #     # # #     #                                       #             # # # # #   # # #                       # # # # #   # # #         # 
# # #     # # # #             # # #     # # #     # # # #             # # #     #                                       #             # # # # #     # #         #             # # # # #     # #         # 
# # #     # # # #                       # # #     # # # #                       #                                       #                                   # # #                                   # # # 
# # #     # # # #         # # # #       # # #     # # # #         # # # #       #                                       #                         # # #     # # #                         # # #     # # # 
# # #     # # # #         # # # #       # # #     # # # #         # # # #       #                                       # # # # # #               # # #         # # # # # #               # # #         # 
# # #                     # # # #       # # #                     # # # #       #                                       # # # # # #               # # #         # # # # # #               # # #         # 
# # #     # # #       # # # # # #       # # #     # # #       # # # # # #       #                                       # # # # # #                             # # # # # #                             # 
# # #     # # #       # # # # #         # # #     # # #       # # # # #         #                                       # # # # # #                             # # # # # #                             # 
# # # # # # # # # # # # # # # # # # # # # # # # # # # # # # # # # # # # # # # # # # # # # # # # # # # # # # # # # # # # # # # # # # # # # # # # # # # # # # # # # # # # # # # # # # # # # # # # # # # # # 
