# # # # # # # # # # # # # # # # # # # # # # # # # # # # # # # # # # # # # # # # # # # # # # # # # # # # # # # # # # # # # # # # # # # # # # # # # # # # # # # # # # # # # # # # # # # # # # # # # # # # # 
#                                       #                                       # #                           # # # # # #       # #                   # #       # # # # # # # #           # # # # # # # # 
# # #                               # # #                                       #                             # # # # # #                                       # # # # # # # #           # # # # # # # # 
# # #                               # # #                                       #           # # #       # # # # # # # # #                                       #                                       # 
# # #                               # # #                                       #           # # # # # # # # # # # # # # #                                       #           # # # # #                   # 
#                                       #                                       #           # # # # # # # # # # # # # # #                                       #           # # # # #   # # # # #   # # # 
#                                       #                                       #                                       #                                       #           # # # # #   # # # # #   # # # 
#                                       #                                       #                                       #                                       #           # # # # #   # # # # #   # # # 
#                                                                                                                                                                                       # # # # #       # 
#                                                         # # #                             # # #       # # #                           # # # # #                                                       # 
#                                                         # # #                             # # #       # # #                           # # # # #                                     # #               # 
#                                                         # # #                             # # #       # # #                           # # # # #                       # # #         # #           # # # 
#                                                                                                                                       # # # # #                       # # #         # #           # # # 
#                                       #                                       #                                       #                 # #                   #                             # # # # # # 
#                                       #                                       #     # #                               #                                       #                             # # # # # # 
#                                       #                                       #     # #         # # #                 #                                       # # # # # # # #     # # # #   # # # # # # 
#                                       #                                       #     # #   # # # # # # # # #           #                                       # # # # # # # #     # # # #   # # # #   # 
#                                       #                                       #     # #   # # #       # # #           # # # #                                 # # # # # # # #     # # # #             # 
#                                       #                                       #                                       # # # #                                 #       # # # #                         # 
# # #                               # # #                                       # #                                   # # # # #   # #               # # # #     #       # # # #                         # 
# # #                               # # # # # # # # # # # # # # # # # # # # # # # # # # # # # #           # # # # # # # # # # # # # # # # # # # # # # # # # # # # # # # # # # #           # # # # # # # # 
# # #                               # # #                                                                       # # #   # # # # # # #               # # # # # # # # # # # # # #           # # # # # # # # 
# # #                               # # #                                                                       # # #   # # # # # # #               # # # # # # # # # # # # # #           # # # # # # # # 
#                                       #                                                                       # # #   # # # # # # #               # # # # # # #                                       # 
#                                       #                                                                       # # #   # # # # # # #               # # # # # # #           # # # # #                   # 
#                                       #                                       # #                                     # # # # # # #               # # # # # # #           # # # # #   # # # # #   # # # 
#                                       #                                       # #                                     # # # # # # #               # # # # # # #           # # # # #   # # # # #   # # # 
#                                       #                               # #   # # #     # # # # #     # # #             #                                       #           # # # # #   # # # # #   # # # 
#                                       #                 # # # # # # # # # # # # # # # # # # # # # # # # #                                                                             # # # # #       # 
#                                       #                 # # # # # # # # # # # # # # # # # # # # # # # # #                                                                                             # 
#                                       #                 # # # # # # # # # # # # # # # # # # # # # # # # #                                                                           # #               # 
#                                       #                 # # # # # # # # # # # #   # # # # #   # # # # # #                                                             # # #         # #           # # # 
#                                       #                                                                                                                               # # #         # #           # # # 
#                                       #                                                                               #                                       #                             # # # # # # 
# # #                               # # #                                                                               # # # # # # #                           #                             # # # # # # 
# # #                               # # #                                                                               # # # # # # #                           # # # # # # # #     # # # #   # # # # # # 
# # #                               # # #                                                                               # # # # # # #                           # # # # # # # #     # # # #   # # # #   # 
# # #                               # # #                                                                               # # # # # # #                           # # # # # # # #     # # # #             # 
#                                       #                                                                               # # # # # # #                           #       # # # #                         # 
#                                       #                                                                               # # # # # # #                           #       # # # #                         # 
# # # # # # # #           # # # # # # # # # # # # # # # # # # # # # # # # # # # # # # # # # # # # # # # # # # # # # # # # # # # # # # # # # # # # # # # # # # # # # # # # # # # # # # # # # # # # # # # # 
#                                       # # # # # # # #           # # # # # # # #   # # #                             # # # #                       # # # #     #                                       # 
#                                       # # # # # # # #           # # # # # # # #   # # #                             # # # #                       # # # #     #                                       # 
#                                       #                                       #                                                                               #                                       # 
#                                       #           # # # # #                   #                                                                               #                                       # 
#                                       #           # # # # #   # # # # #   # # #                                                                               #                                       # 
#                                       #           # # # # #   # # # # #   # # #                                                                               #                                       # 
#                                       #           # # # # #   # # # # #   # # #                                                                               #                                       # 
#                                       #                       # # # # #                                                                                                                               # 
#               # # # #                 #                                                                                                                                         # # #                 # 
#               # # # #                 #                     # #                                                                                                                 # # #                 # 
#               # # # #                 #       # # #         # #           # #                                                                                                   # # #                 # 
#               # # # #                 #       # # #         # #           # #                                                                                                                         # 
#               # # # #                 #                             # # # # # #                                                                               #                                       # 
#               # # # #                 #                             # # # # # #                                                                               #                                       # 
#               # # # #                 # # # # # # # #     # # # #   # # # # # #                                                                               #                                       # 
#             # # # # #                 # # # # # # # #     # # # #   # # # #   #                                                                               #                                       # 
#             # # # # #                 # # # # # # # #     # # # #             #                                                                               #                                       # 
#               # # # #                 #       # # # #                         #   # # #                             # # # #                       # # # #     #                                       # 
#             # # # # #                 #       # # # #                         #   # # #                             # # # #                       # # # #     #                                       # 
#         # # # # # # #                 # # # # # # # #           # # # # # # # # # # # # # # # # # # # # # # # # # # # # # # # # # # # # # # # # # # # # # # # # # # # # # # # # # # # # # # # # # # # # 
#         # # # # # #                   #                                       #                               # # # # #                                       #                               # # # # # 
#               # # # #                 #                                       #       # # #                   # # # # #                                       #       # # #                   # # # # # 
#               # # # #                 #                                       #       # # #                   # # # # #                                       #       # # #                   # # # # # 
#             # # # # #                 #                                       #       # # #                   # # # # #                                       #       # # #                   # # # # # 
#             # # # # #                 #                                       #                               # # # # #                                       #                               # # # # # 
#             # # # # #                 #                                       #             # #                       #                                       #             # #                       # 
#             # # # #                   #                                       #             # # # # # # #             #                                       #             # # # # # # #             # 
#             # # # # #                                                         #               # # # # # #                                                     #               # # # # # #             # 
#               # # # #                               # # # # # # #             #             # # # # # # #                               # # #                 #             # # # # # # #             # 
#               # # # #                               # # # # # # #             #             # # # # # # #                               # # #                 #             # # # # # # #             # 
#             # # # # #                               # # # # # # #             #         # # # # # # # # #                               # # #                 #         # # # # # # # # #             # 
#             # # # # #                                                         #         # # #                                                                 #         # # #                         # 
#             # # # # #                 #                                       #       # # # #   # # # #     # # #     #                                       #       # # # #   # # # #     # # #     # 
#                                       #                                       # #     # # #   # # # # # #   # # #     #                                       # #     # # #   # # # # # #   # # #     # 
#                                       #                                       # #     # # #   # # # # # #   # # #     #                                       # #     # # #   # # # # # #   # # #     # 
# # # # #                               #                                       # #                                     #                                       # #                                     # 
# # # # #                               #                                       #                                       #                                       #                                       # 
# # # # #                               #                                       # # #   # #                 # #         #                                       # # #   # #                 # #         # 
#                                       #                                       # # #   # #                 # #         #                                       # # #   # #                 # #         # 
# # # # # # # #           # # # # # # # # # # # # # # #           # # # # # # # # # # # # # # #           # # # # # # # # # # # # # # # # # # # # # # # # # # # # # # # # # # #           # # # # # # # # 
# #                               # # # #                                       #                                       #                                       #                               # # # # # 
#   # # # #                       # #   #                                       #                                       #                                       #       # # #                   # # # # # 
#   # # # #                         # # #                                       #                                       #                                       #       # # #                   # # # # # 
#   # # # #                         # # #                                       #                                       #                                       #       # # #                   # # # # # 
# # # # # #                         # # #                                       #                                       #                                       #                               # # # # # 
# # # # # #                         # # #                                       #                                       #                                       #             # #                       # 
#                                       #                                       #                                       #                                       #             # # # # # # #             # 
#                                                                                                                                                                               # # # # # #             # 
#                                                         # # #                               # # # # # # #                                                                   # # # # # # #             # 
#                                                         # # #                               # # # # # # #                                                                   # # # # # # #             # 
#                                                         # # #                               # # # # # # #                                                               # # # # # # # # #             # 
#                                                                                                                                                                         # # #                         # 
#                                   #   #                                       #                                       #                                       #       # # # #   # # # #     # # #     # 
#     # # # #                     # # # #                                       #                                       #                                       # #     # # #   # # # # # #   # # #     # 
#     # # # #                     # # # #                                       #                                       #                                       # #     # # #   # # # # # #   # # #     # 
#     # # # #                 # # # # # #                                       #                                       #                                       # #                                     # 
#   # # # #                   # # # #   #                                       #                                       #                                       #                                       # 
#     # # #                   # # # #   #                                       #                                       #                                       # # #   # #                 # #         # 
# #   # #                     # # # # # #                                       #                                       #                                       # # #   # #                 # #         # 
# # # # # # # # # # # # # # # # # # # # # # # # # # # # # # # # # # # # # # # # # # # # # # # # # # # # # # # # # # # # # # # # # # # # # # # # # # # # # # # # # # # # # # # # # # # # # # # # # # # # # 
