# # # # # # # # # # # # # # # # # # # # # # # # # # # # # # # # # # # # # # # # # # # # # # # # # # # # # # # # # # # # # # # # # # # # # # # # # # # # # # # # # # # # # # # # # # # # # # # # # # # # # 
#                                                                               #                                       #                           # # #   # # # # # # # # #               # # # # # # # 
#                                                                               #                                       #                                   # # # # # # # # #               # # # # # # # 
#                                                                               #                                       #                                       # # # # # # #               # # # # # # # 
# # # #                                                                         #                                       #   # # #                 # # #     # # # # # # # # #               # # # # # # # 
# # # #                                                                         #                                       #   # # #             # # # # #     # # # # # # # # #               # # # # # # # 
# # # #                       # # # # # # # # #                                 #                                       #   # # #             # # # # #         # # # # # # #               # # # # # # # 
# # # #                       # # # # # # # # #                                 #                                       #           # #   # # # # #             #                                       # 
#                             # # # # # # # # #                                                                                     # # # # # #     # #                                                 # 
#                             # # # # # # # # #                                                   # # #                               # # # # #   # # #                                                 # 
#                   # #       # # # # # # # # #           # # #                                   # # #                               # # # # #   # # #                                                 # 
#                             # # # # # # # # #                                                   # # #                               # # # # #   # # #                                                 # 
#                             # # # # # # # # #                                                                                       # # # # #   # # #                                                 # 
#                             # # # # # # # # #                                 #                                       #             # # # # #     # #         #                                       # 
#                             # # # # # # # # #                                 #                                       #                                   # # # # # # # # #                           # 
#                                                                               #                                       #                         # # #     # # # # # # # # #                           # 
#                                                                               #                                       # # # # # #               # # #         # # # # # # #                           # 
#                                                                               #                                       # # # # # #               # # #         # # # # # # #                           # 
#                                                                               #                                       # # # # # #                             # # # # # # #                           # 
#                                                                               #                                       # # # # # #                             # # # # # # #                           # 
# # # # # # # #           # # # # # # # # # # # # # # #           # # # # # # # # # # # # # # #           # # # # # # # # # # # # # # #           # # # # # # # # # # # # # # #           # # # # # # # # 
#                                       #                                       # # #                         # # # # # #                                       # #                             # # # # # 
#                                       # #                                   # # # #                         # # # # # #                                       #                               # # # # # 
#                                       # #                                     # # #                         # # # # # #                                       #                                 # # # # 
#                                       #                                       # # #                 # #     # # # # # #                                       #                                 # # # # 
#                                       #                                       # # #                 # #     # # # # # #                                       #                                       # 
#                                       #                                       # # #   # # # #       # #     # # # # # #                                       #                                       # 
#                                       #                                       # # #   # # # #               # # # # # #                                       #                                       # 
#                                       #                                               # # # #                                                                                   # # #                 # 
#                 # # #                 #                 # # #                         # # # #                                                                                   # # #                 # 
#                 # # #                 #                 # # #                         # # # #               # # #                                                               # # #                 # 
#                 # # #                 #                 # # #                                     # # #     # # #                                                               # # #                 # 
#                                       #                   #                             # # # #   # # #     # # #                                                                                     # 
#                                       #                   #                   # # #     # # # #             # # #     #                                       #                                       # 
#                                       #                                       # # #     # # # #                       #                                       # # #                                   # 
#                                       #                                       # # #     # # # #         # # # #       #                                     # # # # # #                               # 
#                                       #                                       # # #     # # # #         # # # #       #                                     # # # # # #                               # 
#                                       # #                                   # # # #                     # # # #       #                                     # # # # # #                               # 
#                                       #                                       # # #     # # #       # # # # # #       #                                       # # # # #                               # 
#                                       #                                       # # #     # # #       # # # # #         #                                       # # # # #         # # #                 # 
# # # # # # # #           # # # # # # # # # # # # # # #           # # # # # # # # # # # # # # #           # # # # # # # # # # # # # # #           # # # # # # # # # #             # # #         # # # # # 
#                           # # #   # # # #                                   # #                             # # # #   # # # # # # #               # # # # # # # # #             # # #         # # # # # 
#                                   # # #                                       #                             # # # #   # # # # # # #               # # # # # # # # #                           # # # # # 
#                                       #                           # # # #     #       # #                   # # # #   # # # # # # #               # # # # # # #                                 # # # # 
#   # # #                 # # #     # # #                           # # # #     #       # #       # # #       # # #     # # # # # # #               # # # # # # #                                 # # # # 
#   # # #             # # # # #     # # #                                       #       # #       # # #                 # # # # # # #               # # # # # # #                                   # # # 
#   # # #             # # # # #         #     # # #       # # #         # #     #                 # # #                 # # # # # # #               # # # # # # #                                       # 
#           # #   # # # # #             #     # # #       # # #         # #     #                 # # #                 #                                       #                 # # #                 # 
#           # # # # # #     # #         #     # # #       # # #         # #                 # # # # # # # # #           #                                       #               # # # #                 # 
#             # # # # #   # # #         #       # #                   # #                   # # # # # # # # #           #                                       #               # # # #                 # 
#             # # # # #   # # #         #       # #                   # #                   # # # # # # # # #           #                                       #               # # # #                 # 
#             # # # # #   # # #         #       # #                   # #                   # # # # # # # # #           #                                       #                 # # #                 # 
#             # # # # #   # # #         #     # # #       # # #         # #                 # # # # # # # # #           #                                       #                 # # #                 # 
#             # # # # #     # #         #     # # #       # # #         # #     #           # # # # # # # # #           #                                       #                                       # 
#                                   # # #     # # #       # # #         # #     #                                       # # # # # # #                           #                                       # 
#                         # # #     # # # # # # # #                             #   # # # # # #               # # #     # # # # # # #                           #                                       # 
# # # # # #               # # #         # # # # # #                             #   # # # # # #               # # # # # # # # # # # #                           #                                       # 
# # # # # #               # # #         # # # # # #                             #   # # # # # #             # # # # # # # # # # # # #                           #                                       # 
# # # # # #                             # # # # # #                             #                           # # # # # # # # # # # # #                           #                                       # 
# # # # # #                             # # # # # #                           # #                           # # # # # # # # # # # # #                           # #                                   # # 
# # # # # # # # # # # # # # # # # # # # # # # # # # # #           # # # # # # # # # # # # # # #           # # # # # # # # # # # # # # #           # # # # # # # # # # # # # # # # # # # # # # # # # # # # 
#                                                                               # # #                         # # # # # # #       # #                         # #                                       # 
#                                                                               # # #                         # # # # # #   # # # # #                     #     #                                       # 
#                                                                               # # #                         # # # # # #   # # # # #               # # # # # # #                                       # 
#                                                                               # # #                 # #     # # # # # #   # # # # #               # # # # # # #                                       # 
#                                                                               # # #                 # #     # # # # # #   # # # # #               # # # # #   #                                       # 
#                                                                               # # #   # # # #       # #     # # # # # #                           # # #       #                                       # 
#                                                                               # # #   # # # #               # # # # # #                                       #                                       # 
#                                                                               #       # # # #                         #                                                                               # 
#                   # #                 # #                 # #                 #       # # # #                         #                                                         # # #                 # 
#                   # #                 # #                 # #                 #       # # # #               # # #     #                                                         # # #                 # 
#                   # #                 # #                 # #                 #                   # # #     # # #     #                                                         # # #                 # 
#                                                                               #         # # # #   # # #     # # #     #                                                                               # 
#                                                                               # # #     # # # #             # # #     #                                       #                                       # 
#                                                                               # # #     # # # #                       #                                       #                                       # 
#                                                                               # # #     # # # #         # # # #       #                               # # # # #                                       # 
#                                                                               # # #     # # # #         # # # #       #                               # # # # #                                       # 
#                                                                               # # #                     # # # #       # # #                       # # # # # # #                                       # 
#                                                                               # # #     # # #       # # # # # #       # # # # # # #             # # # # # # # #                                       # 
#                                                                               # # #     # # #       # # # # #         # # # # # # #               # # # # # # #                                       # 
# # # # # # # #           # # # # # # # # # # # # # # #           # # # # # # # # # # # # # # #           # # # # # # # # # # # # # # #           # # # # # # # # # # # # # # #           # # # # # # # # 
#                                 # # # #                                       #                           # # #   # # #                                                                               # 
#                                 # # # #                                       #                                   # # #                                                                               # 
#                                 # # # #                                       #                                       #                                                                               # 
# #                                     #                                       #   # # #                 # # #     # # # # # #                                                                         # 
# #                                   # #                                       #   # # #             # # # # #     # # # # # #                                                                         # 
#                                     # #                                       #   # # #             # # # # #         # # # #                       # # # # # # # # #                                 # 
#                                       #                                       #           # #   # # # # #             # # # #                       # # # # # # # # #                                 # 
#                 # # # #                                                                   # # # # # #     # #                                       # # # # # # # # #                                 # 
#                 # # # # #                               # # #                               # # # # #   # # #                                       # # # # # # # # #                                 # 
#                 # # # # #                               # # #                               # # # # #   # # #                             # #       # # # # # # # # #           # # #                 # 
#                 # # # #                                 # # #                               # # # # #   # # #                                       # # # # # # # # #                                 # 
#                 # # # #                                                                     # # # # #   # # #                                       # # # # # # # # #                                 # 
#                                       #                                       #             # # # # #     # #         #                             # # # # # # # # #                                 # 
#                                     # #                                       #                                   # # #                             # # # # # # # # #                                 # 
# #                                   # #                                       #                         # # #     # # #                                                                               # 
# #                                   # #                                       # # # # # #               # # #         #                                                                               # 
#                                     # #                                       # # # # # #               # # #         #                                                                               # 
#                                       #                                       # # # # # #                             #                                                                               # 
#                                       #                                       # # # # # #                             #                                                                               # 
# # # # # # # # # # # # # # # # # # # # # # # # # # # # # # # # # # # # # # # # # # # # # # # # # # # # # # # # # # # # # # # # # # # # # # # # # # # # # # # # # # # # # # # # # # # # # # # # # # # # # 
