# # # # # # # # # # # # # # # # # # # # # # # # # # # # # # # # # # # # # # # # # # # # # # # # # # # # # # # # # # # # # # # # # # # # # # # # # # # # # # # # # # # # # # # # # # # # # # # # # # # # # # # # # # # # # # # # # # # 
# # # # # # # # # # # # # # # # # # #             # # # # # # # # # # # # # # # # # # # # # # # # # # # # #                                                                                                                       # # 
# # # # # # # # # # # # # # # # # # #               # # # # # # # # # # # # # # # # # # # # # # # # # # #                                                                                                                           # 
# # # # # # # # # # # # # # # #                     # # # # # # # # # # # # # # # # # # # # # # # # # # #                                                                                                                           # 
# # # # # # # # # # # # # # # #                     # # # # # # # # # # # # # # # # # # # # # # # # # # #                                                                                                                           # 
# # # # # # # # # # # # # # # #                     # # # # # # # # # # # # # # # # # # # # # # # # # # #                 # # # # #                                               # # # #                                           # 
# # # # # # # # # # # # # # # #                     # # # # # # # # # # # # # # # # # # # # # # # # # # #                 # # # # # # # # # # # #                   # # # # # # # # # # # # # # # # # # #                           # 
# # # # # # # # # # # # # # # #                     # # # # # # # # # # # # # # # # # # # # # # # # # # #                 # # # # # # # # # # # #                   # # # # # # # # # # # # # # # # # # #                           # 
# # # # # # # # # # # # # # # #                     # # # # # # # # # # # # # # # # # # # # # # # # # # # #               # # # # # # # # # # # #                   # # # # # # # # # # # # # # # # # # #                           # 
# # # # # # # # # # # # # # # #                     # # # # # # # # # # # # # # # # # # # # # # # # # # # #               # # # # #                                               # # # # # # # # # # # #                           # 
# # # # # # # # # # # # # # # #                     # # # # # # # # # # # # # # # # # # # # # # # # # # # #               # # # #                                                   # # # # # # # # # # #                           # 
# # # # # # # # # # # # # # # #                     # # # # # # # # # # # # # # # # # # # # # # # # # # #                 # # # #                                                   # # # # # # # # # # #                           # 
# # # # # # # # # # # # # # # #               # # # # # # # # # # # # # # # # # # # # # # # # # # # # # #                 # # # #                                                   # # # # # # # # # # #                           # 
# # # # # # # # # # # # # # # #               # # # # # # # # # # # # # # # # # # # # # # # # # # # # # #                   # # #                                                   # # # # # # # # # # #                           # 
# # # # # # # # # # # # # # # #               # # # # # # # # # # # # # # # # # # # # # # # # # # # # # #                 # # # # #             # # # # # # # # # # #               # # # # # # # # # # #                           # 
# # # # # # # # # # # # # # # #                     # # # # # # # # # # # # # # # # # # # # # # # # # # #                 # # # # # #           # # # # # # # # # # #               # # # # # # # # # # #                           # 
# # # # # # # # # # # # # # # #                     # # # # # # # # # # # # # # # # # # # # # # # # # # #                 # # # # # #           # # # # # # # # # # # #             # # # # # # # # # # #                           # 
# # # # # # # # # # # # # # # #                     # # # # # # # # # # # # # # # # # # # # # # # # # # #                 # # # # # #           # # # # # # # # # # # #             # # # # # # # # # # #                           # 
# # # # # # # # # # # # # # # #                     # # # # # # # # # # # # # # # # # # # # # # # # # # #                 # # # # # #           # # # # # # # # # # # #             # # # # # # # # # # #                           # 
# # # # # # # # # # # # # # # #                     # # # # # # # # # # # # # # # # # # # # # # # # # # #                 # # # # # #           # # # # # # # # # # # #             # # # # # # # # # # #                           # 
# # # # # # # # # # # # # # # #                     # # # # # # # # # # # # # # # # # # # # # # # # # # #                 # # # # #             # # # # # # # # # # # #             # # # # # # # # # # #                           # 
# # # # # # # # # # # # # # # #                     # # # # # # # # # # # # # # # # # # # # # # # # # # #                   # # #               # # # # # # # # # # # #             # # # # # # # # # # #                           # 
# # # # # # # # # # # # # # # #                     # # # # # # # # # # # # # # # # # # # # # # # # # # #                   # # #               # # # # # # # # # # # #             # # # # # # # # # # #                         # # 
# # # # # # # # # # # # # # # #                     # # # # # # # # # # # # # # # # # # # # # # # # # # #                   # # #               # # # # # # # # # # #               # # # # # # # # # # #                         # # 
# # # # # # # # # # # # # # # # #                   # # # # # # # # # # # # # # # # # # # # # # # # # # #                   # # #               # # # # # # # # # # #               # # # #         # # #                         # # 
# #       # # # # # # #     # # #                   # # # # # # # # # # # # # # # # # # # # # # # # # # #                 # # # #               # # # # # # # # # # # #             # # # #         # # #                           # 
#             # # # #       # # #                   # # # # # # # # # # # # # # # # # # # # # # # # # # #                 # # # #               # # # # # # # # # # # #             # # # #         # # #                           # 
#                           # # #                   # # # # # # # # # # # # # # # # # # # # # # # # # # #                 # # # #               # # # # # # # # # # # #             # # # #         # # #                           # 
#                           # # #                 # # # # # # # # # # # # # # # # # # # # # # # # # # # #                   # # #               # # # # # # # # # # # #             # # # #                                         # 
#                           # # #                 # # # #                                           # # #                   # # # #             # # # # # # # # # # # #           # # # # #                                         # 
#                       # # # # #                 # # # #                   # # # # # # # # #       # # #                   # # # #             # # # # # # # # # # # #           # # # # # # # # # # # #                           # 
#                       # # # # #                   # # #                   # # # # # # # # #       # # #                   # # # #             # # # # # # # # # # #             # # # # # # # # # # # #                           # 
#                       # # # # #                   # # #                   # # # # # # # # #       # # #                   # # # #             # # # # # # # # # # #             # # # # # # # # # # # #                           # 
#                                                                           # # # # # # # #                                 # # # #                                               # # # # # # # # # # #                             # 
#                                                                                                                                                                                   # # # # # # # # # #                             # 
#                                                                                                                                                                                   # # # # # # # # # #                             # 
#                                                                                                                                                                                   # # # # # # # # # #                             # 
#                                                                     # # #                                                                                                         # # # # # # # # # #                             # 
#                           # # #                                 # # # # # # # # # # # #                                   # # #                     # # # #                       # # # # # # # # # # # #                         # 
#                           # # #                                 # # # # # # # # # # # #                                   # # #                     # # # #                       # # # # # # # # # # # #                         # 
#                           # # #                                 # # # # # # # # # # # #                                   # # #                     # # # #                       # # # # # # # # # # # #                         # 
#                                                                         #                                                                                                         # # # # # # # # # #                             # 
#                                                                                                                                                                                   # # # # # # # # # #                             # 
#                                                                                                                                                                                   # # # # # # # # # #                             # 
#                                                                                                                                                                                   # # # # # # # # # #                             # 
#                                                                                                                           # # # #                                               # # # # # # # # # # #                             # 
#                         # # # #                   # # #       # # # # # # # # # #                 # # #                   # # # #             # # # # # # # # # # #             # # # # # # # # # # # #                           # 
#                         # # # #                   # # #       # # # # # # # # # #                 # # #                   # # # #             # # # # # # # # # # #             # # # # # # # # # # # #                           # 
#                         # # # #                   # # #       # # # # # # # # # #                 # # #                   # # # #             # # # # # # # # # # #             # # # # # # # # # # # #                           # 
#                             # #                   # # #                                         # # # #                   # # # #           # # # # # # # # # # # #             # # # #                                           # 
#                             # #                   # # # # # # # # # # # # # # # # # # # # # # # # # # #                   # # #             # # # # # # # # # # # #               # # #                                           # 
#                             # #                   # # # # # # # # # # # # # # # # # # # # # # # # # # #                 # # # #             # # # # # # # # # # # #               # # #                                           # 
# # # # # # #         # # # # # #                   # # # # # # # # # # # # # # # # # # # # # # # # # # #                 # # # #               # # # # # # # # # # #               # # #           # # #                           # 
# # # # # # #         # # # # # #                   # # # # # # # # # # # # # # # # # # # # # # # # # # #                 # # # #               # # # # # # # # # # #               # # # #         # # #                           # 
# # # # # # # # # # # # # # # # #                   # # # # # # # # # # # # # # # # # # # # # # # # # # #                 # # # #               # # # # # # # # # # #               # # # # # # # # # # #                         # # 
# # # # # # # # # # # # # # # # #                   # # # # # # # # # # # # # # # # # # # # # # # # # # #                 # # # #               # # # # # # # # # # #               # # # # # # # # # # #                         # # 
# # # # # # # # # # # # # # # # #                   # # # # # # # # # # # # # # # # # # # # # # # # # # #                 # # # #             # # # # # # # # # # # #               # # # # # # # # # # #                         # # 
# # # # # # # # # # # # # # # # #                   # # # # # # # # # # # # # # # # # # # # # # # # # # #                 # # # #             # # # # # # # # # # # #               # # # # # # # # # # #                           # 
# # # # # # # # # # # # # # # # #                   # # # # # # # # # # # # # # # # # # # # # # # # # # #                 # # # #             # # # # # # # # # # # #               # # # # # # # # # # #                           # 
# # # # # # # # # # # # # # # # #                   # # # # # # # # # # # # # # # # # # # # # # # # # # #                 # # # #             # # # # # # # # # # # #               # # # # # # # # # # #                           # 
# # # # # # # # # # # # # # # # #                   # # # # # # # # # # # # # # # # # # # # # # # # # # #                 # # # #             # # # # # # # # # # # #               # # # # # # # # # # #                           # 
# # # # # # # # # # # # # # # # #                   # # # # # # # # # # # # # # # # # # # # # # # # # # #                   # # #             # # # # # # # # # # # #               # # # # # # # # # # #                           # 
# # # # # # # # # # # # # # # # #                   # # # # # # # # # # # # # # # # # # # # # # # # # # # #                 # # #             # # # # # # # # # # # #               # # # # # # # # # # #                           # 
# # # # # # # # # # # # # # # # #                   # # # # # # # # # # # # # # # # # # # # # # # # # # # #                 # # #             # # # # # # # # # # # #               # # # # # # # # # # #                           # 
# # # # # # # # # # # # # # # # #                   # # # # # # # # # # # # # # # # # # # # # # # # # # # #                 # # # #           # # # # # # # # # # # #               # # # # # # # # # # #                           # 
# # # # # # # # # # # # # # # # #                   # # # # # # # # # # #               # # #       # # # #               # # # # #                                                 # # # # # # # # # # #                           # 
# # # # # # # # # # # # # # # # #                   # # # # # # # # # # #               # # #       # # # #               # # # # #                                                 # # # # # # # # # # #                           # 
# # # # # # # # # # # # # # # # #             # # # # # # # # # # # # # #               # # #       # # # #               # # # #                                                   # # # # # # # # # # #                           # 
# # # # # # # # # # # # # # # # #             # # # # # # # # # # # # # #               # # #       # # # #                 # # #                                                   # # # # # # # # # # #                           # 
# # # # # # # # # # # # # # # # #             # # # # # # # # # # # # # #               # # #       # # #                   # # # #                                               # # # # # # # # # # # #                           # 
# # # # # # # # # # # # # # # # #                   # # # # # # # # # # #               # # #       # # #                 # # # # # # # # # # #                       # # # # # # # # # # # # # # # # # #                           # 
# # # # # # # # # # # # # # # # #                   # # # # # # # # # # #               # # #       # # #                 # # # # # # # # # # #                       # # # # # # # # # # # # # # # # # #                           # 
# # # # # # # # # # # # # # # # #                   # # # # # # # # # # #               # # #       # # #                 # # # # # # # # # # #                       # # # # # # # # # # # # # # # # # #                           # 
# # # # # # # # # # # # # # # # #                   # # # # # # # # # # #                           # # #                 # # # # #                                               # # # #                                           # 
# # # # # # # # # # # # # # # # #                   # # # # # # # # # # #                           # # #                                                                                                                           # 
# # # # # # # # # # # # # # # # #                   # # # # # # # # # # #                           # # #                                                                                                                           # 
# # # # # # # # # # # # # # # # #                   # # # # # # # # # # #                         # # # #                                                                                                                           # 
# # # # # # # # # # # # # # # # #       # # #       # # # # # # # # # # #     #   # # #           # # # # #                                                                                                                       # # 
# # # # # # # # # # # # # # # # # # # # # # # # # # # # # # # # # # # # # # # # # # # # # # # # # # # # # # # # # # # # # # # # # # # # # # # # # # # # # # # # # # # # # # # # # # # # # # # # # # # # # # # # # # # # # # # # # # # 
