# # # # # # # # # # # # # # # # # # # # # # # # # # # # # # # # # # # # 
# # # # # # # # # # # # # # # # # # # # # # # # # # # # # # # # # # # # 
# # # # # # # # # # # # #                       # # #             # # # 
# # # # # # # # # # # # #                       # # #             # # # 
# # # # # # # # # # # # #                       # # #             # # # 
# # # # # # # # # # # # #                       # # #             # # # 
# # # # # # # # # # # # #                       # # #             # # # 
# # # # # # # # # # # # #                       # # # #           # # # 
# # # # # # # # # # # # # #                                       # # # 
# # # # # # # # # # # # # # # # #                                 # # # 
# # # # # # # # # # # # # # # # #                                 # # # 
# # # # # # # # # # # # # # # # #                                 # # # 
# # # # # # # # # # # # # # # # #                                 # # # 
# # # # # # # # # # # # # # # # #                                 # # # 
# # # # # # # # # # # # # # # # # # # # # # # # # # # # # # # # # # # # 
# # # # # # # # # # # # # # # # # # # # # # # # # # # # # # # # # # # # 
# #             # # # # # # # # # # # # # # # # # # # # # # # # # # # # 
# #             # # # # # # # # # # # # # # # # # # # # # # # # # # # # 
# #             # # # # # # # # # # # # # # # # # # # # # # # # # # # # 
# #             # # # # # # # # # # # # # # # # # # # # # # # # # # # # 
# #             # # # # # # # # # # # # # # # # # # # # # # # # # # # # 
# #             # # # # # # # # # # # # # # # # # # # # # # # # # # # # 
# #             # # # # # # # # # # # # # # # # # # # # # # # # # # # # 
# #             # # # # # # # # # # # # # # # # # # # # # # # # # # # # 
# #             # # # # # # # # # # # # # # # # # # # # # # # # # # # # 
# #             # # # # # # # # # # # # # # # # # # # # # # # # # # # # 
# #             # # # # # # # # # # # # # # # # # # # # # # # # # # # # 
# #             # # # # # # # # # # # # # # # # # # # # # # # # # # # # 
# # # # # # # # # # # # # # # # # # # # # # # # # # # # # # # # # # # # 
# # # # # # # # # # # # # # # # # # # # # # # # # # # # # # # # # # # # 
# # # # # # # # # # # # # # # # # # # # # # # # # # # # # # # # # # # # 
