# # # # # # # # # # # # # # # # # # # # # # # # # # # # # # # # # # # # # # # # # # # # # # # # # # # # # # # # # # # # # # # # # # # # # # # # # # # # # # # # # # # # # # # # # # # # # # # # # # # # # 
# #                               # # # # # # # # # # #             # # # # # # #             # # # # # # # #           #                                       #                                       # 
#   # # # #                       # #   # # # # # # # #             # # # # # # #             # # # # # # # #           # # #                             # # # #       # # #                   # # # # # 
#   # # # #                             #                           # #         #                                       # # #                             # # # #       # # #                   # # # # # 
#   # # # #                       # # # #                                       #                                       # # #                             # # # #       # # #                   # # # # # 
#   # # # #                       # # # #           # # # #     # # # # #   # # #                                       #                                 # # # #                                       # 
# # # # # #                             #           # # # #     # # # # #   # # #                                       #                                       #                 # # # #               # 
#                                       #           # # # #     # # # # #   # # #                                       #                                       #             # # # # # # #             # 
#                                                               # # # # #                         # # #                 #                                                         # # # # #             # 
#                                                                                                 # # #                 #                                                     # # # # # # # #           # 
#                                                             # # #                               # # #                 #                                                     # # # # # # # #           # 
#                                               # # #         # # #         # #                   # # #                 #                                                 # # # # # # # # # #           # 
#                                               # # #         # # #         # #                   # # #                 #                                                 # # #                         # 
#                                       #       # # #                 # # # # # #                 # # #                 #                                       #         # # #   # # # #     # # #     # 
#     # # # #                     # # # #                   # # # #   # # # # # #                                       #                                       # #       # #     # # # #     # # #     # 
#     # # # #                     # # # # # # # # # # #     # # # #   # # # # # #                                       #                                       # #               # # # #     # # #     # 
#     # # # #                           # # # # # # # #     # # # #   # # # #   #                                       #                                       # #                                     # 
#   # # # #                   # # # #   # # # # # # # #     # # # #             # # # #                                 #                                       #                                       # 
#     # # #                   # # # #   #     # # # # #                         # # # #                                 #                                       # # #   # #                 # #         # 
# #                           # # # # # #                                       # # # #   # #               # # # #     # # #                             # # # # # #   # #                 # #         # 
# # # # # # # #           # # # # # # # # # # # # # # #           # # # # # # # # # # # # # # #           # # # # # # # # # #                             # # # # # # # # # # #           # # # # # # # # 
# #                                                                           # #                                       # # #                             # # # # # # # # # # #             # # # # # # # 
#                                                                               #                                       # # #                             # # # # # # # # # # #             # # # # # # # 
#                                                                               #                                       #                                       #                           # #         # 
#                                                                               #                                       #                                       #                                       # 
#                                                                               #                                       #                                       #           # # # #     # # # # #   # # # 
#                                                                               #                                       #                                       #           # # # #     # # # # #   # # # 
#                                                                               #                                       #                                       #           # # # #     # # # # #   # # # 
#                                                                                                                                                                                       # # # # #       # 
#                                                                                                 # # #                                                                                                 # 
#                                                           # # # #                               # # #                                                                               # # #             # 
#                                       # # # #             # # # #                               # # #                                                                 # # #         # # #         # # # 
#                                       # # # #         # # # # # #                                                                                                     # # #         # # #         # # # 
#                                       # # # #         # # # # # #             #                                       #                                       #       # # #                 # # # # # # 
#                                                       # # # # # #             #                                       # # #                             # # # #                   # # # #   # # # # # # 
#                                                       # # # # # #             #                                       # # #                             # # # # # # # # # # #     # # # #   # # # # # # 
#                                                       # # # # # #             #                                       # # #                             # # # # # # # # # # #     # # # #   # # # #   # 
#                                                       # # # #                 #                                       # # #                             # # # # # # # # # # #     # # # #             # 
#                                                                               #                                       #                                       #     # # # # #                         # 
# #                                                                           # #                                       #                                       #                                       # 
# # # # # # # # # # # # # # # # # # # # # # # # # # # #           # # # # # # # # # # # # # # #           # # # # # # # # # # # # # # #           # # # # # # # # # # # # # # #           # # # # # # # # 
# #                               # # # #                                                                       # # #   # # # # # # # #             # # # # # # #                                       # 
#   # # # #                       # #   #                                                                       # # #   # # # # # # # #             # # # # # # #                                       # 
#   # # # #                             #                                                                       # # #   #                           # #         #                                       # 
#   # # # #                       # # # #                                                                               #                                       #                                       # 
#   # # # #                       # # # #                                       # #                                     #           # # # #     # # # # #   # # #                                       # 
# # # # # #                             #                                       # #                                     #           # # # #     # # # # #   # # #                                       # 
#                                       #                               # # # # # # # # # # # # # # # # # # #           #           # # # #     # # # # #   # # #                                       # 
#                                                       # # # # # # # # # # # # # # # # # # # # # # # # # # #                                   # # # # #                                               # 
#                                                       # # # # # # # # # # # # # # # # # #   # # # # # # # #                                                                 # # # # # # # #           # 
#                                                       # # # # # # # # # # # # # # # # # #   # # # # # # # #                                 # # #                           # # # # # # # #           # 
#                                                       # # # # # # # # # # # # # # # # # #   # # # # # # # #                   # # #         # # #         # #               # # # # # # # #           # 
#                                                                           # # # # # # # #   # # # #                           # # #         # # #         # #                                         # 
#                                       #                                                                               #       # # #                 # # # # # #                                       # 
#     # # # #                     # # # #                                                                               #                   # # # #   # # # # # #                                       # 
#     # # # #                     # # # #                                                                               # # # # # # # #     # # # #   # # # # # #                                       # 
#     # # # #                           #                                                                               # # # # # # # #     # # # #   # # # #   #                                       # 
#   # # # #                   # # # #   #                                                                               # # # # # # # #     # # # #             #                                       # 
#     # # #                   # # # #   #                                                                               #     # # # # #                         #                                       # 
# #                           # # # # # #                                                                               #                                       #                                       # 
# # # # # # # #           # # # # # # # # # # # # # # #           # # # # # # # # # # # # # # #           # # # # # # # # # # # # # # # # # # # # # # # # # # # # # # # # # # #           # # # # # # # # 
#   # #                           #     #                                       #                                       #                                       #                                       # 
#                                       #                                       #                                       #                             # # #     #                                       # 
#                                       #                                       #                                       #                             # # #     #                                       # 
#                                       #                                       #                                       #     # # #                   # # #     #                                       # 
#                                       #                                       #                                       #     # # #   # # # # # # #   # # #     #                                       # 
#                                       #                                       #                                       #             # # # # # # #   # # #     #                                       # 
#                                       #                                       #                                       #             # # # # # # #   # # #     #                                       # 
#                                       #                                                                                             # # # # # # #                                                     # 
#                 # # #                 #                 # # #                                                                     # # # # # # # #                           # # # # # # # #           # 
#                 # # # # #             #                 # # #                                     # #                           # # # # # # # # #                           # # # # # # # #           # 
#                 # # #                 #                 # # #                                     # #                             # # # # # # # #                           # # # # # # # #           # 
#                                       #                                                                                             # # # # # # #                                                     # 
#                                       #                                       #                                       #             # # # # # # #             #                                       # 
#                                       #                                       #                                       #             # # # # # # #       # # # #                                       # 
#                                       #                                       #                                       # # # #       # # # # # # #       # # # #                                       # 
#                                       #                                       #                                       # # # # #                     # # # # # #                                       # 
#                                       #                                       #                                       # # # # #                     # # # # # #                                       # 
#                                       #                                       #                                       # # # #                         # # # # #                                       # 
#   #                             #     #                                       #                                       #                               # # # # #                                       # 
# # # # # # # # # # # # # # # # # # # # # # # # # # # # # # # # # # # # # # # # #                   # #                 # # # # # # # # # # # # # # # # # # # # # # # # # # # #           # # # # # # # # 
#                                       #                                       #                   # #                 #           #           # # # # # #     #           #           # # # # # #     # 
#       # # #                   # # # # #                                       #                                       #           #           # # # # # #     #           #           # # # # # #     # 
#       # # #                   # # # # #                                       #                                       #           #           # # # # # #     #           #           # # # # # #     # 
#       # # #                   # # # # #                                       #                                       # # # # # # #           # # # # # # # # # # # # # # #           # # # # # # # # # 
#                                       #                                       #                                       # # # # # # #           # # # # # # # # # # # # # # #           # # # # # # # # # 
#                 # # # #               #                                       #                                       # # # # # # #               # # # # # # # # # # # # #               # # # # # # # 
#             # # # # # # #             #                                       #                                       # # # # # # #               # # # # # # # # # # # # #               # # # # # # # 
#                 # # # # #                                                                                                                                                                             # 
#             # # # # # # # #                                                                                                                                                                           # 
#             # # # # # # # #                                                                       # #                                                                                                 # 
#         # # # # # # # # # #                                                                       # #                                                                                                 # 
#         # # #                                                                                                                                                                                         # 
#         # # #   # # # #     # # #     #                                       #                                       # # # # # # #                           # # # # # # #                           # 
# #       # #     # # # #     # # #     #                                       #                                       # # # # # # #                           # # # # # # #                           # 
# #               # # # #     # # #     #                                       #                                       # # # # # # #                           # # # # # # #                           # 
# #                                     #                                       #                                       # # # # # # #                           # # # # # # #                           # 
#                                       #                                       #                                       #           #                           #           #                           # 
# # #   # #                 # #         #                                       #                                       #           #                           #           #                           # 
# # #   # #                 # #         #                                       #                                       #           #                           #           #                           # 
# # # # # # # # # # # # # # # # # # # # # # # # # # # # # # # # # # # # # # # # # # # # # # # # # # # # # # # # # # # # # # # # # # # # # # # # # # # # # # # # # # # # # # # # # # # # # # # # # # # # # 
