# # # # # # # # # # # # # # # # # # # # # # # # # # # # # # # # # # # # # # # # # # # # # # # # # # # # # # # # # # # # # # # # # # # # # # # # # # # # # # # # # # # # # # # # # # # # # # # # # # # # # 
#                                       #                                       # #                           # # # # # #       # # # # # # # # # # # # #       # # # # # # # #           # # # # # # # # 
# # #                             # # # #                                       #                             # # # # # #           # # # # # # # # #           # # # # # # # #           # # # # # # # # 
# # #                             # # # #                                       #           # # #       # # # # # # # # #                                       #                           # #         # 
# # #                             # # # #                                       #           # # # # # # # # # # # # # # #                                       #                                       # 
#                                 # # # #                                       #           # # # # # # # # # # # # # # #                                       #           # # # #     # # # # #   # # # 
#                                       #                                       #                                       #                                       #           # # # #     # # # # #   # # # 
#                                       #                                       #                                       #                                       #           # # # #     # # # # #   # # # 
#                                                                                                                                         # # #                                         # # # # #       # 
#                                                         # # #                             # # #       # # #                             # # #                                                         # 
#                                                         # # #                             # # #       # # #                           # # # #                                       # # #             # 
#                                                         # # #                             # # #       # # #                           # # # #                         # # #         # # #         # # # 
#                                                                                                                                         # # #                         # # #         # # #         # # # 
#                                       #                                       #                                       #                 # # #                 #       # # #                 # # # # # # 
#                                       #                                       #     # #                               #                                       #                   # # # #   # # # # # # 
#                                       #                                       #     # #         # # #                 #                                       # # # # # # # #     # # # #   # # # # # # 
#                                       #                                       #     # #   # # # # # # # # #           #                                       # # # # # # # #     # # # #   # # # #   # 
#                                       #                                       #     # #   # # #       # # #           # # # #                                 # # # # # # # #     # # # #             # 
#                                       #                                       #                                       # # # #                                 #     # # # # #                         # 
# # #                             # # # #                                       # #                                   # # # # #   # #               # # # #     #                                       # 
# # #                             # # # # # # # # # # # # # # # # # # # # # # # # # # # # # # #           # # # # # # # # # # # # # # # # # # # # # # # # # # # # # # # # # # #           # # # # # # # # 
# # #                             # # # #                                                                       # # #   # # # # # # #           # # # # # # # # # # # # # # # #           # # # # # # # # 
# # #                             # # # #                                                                       # # #   # # # # # # #           # # # # # # # # # # # # # # # #           # # # # # # # # 
#                                       #                                                                       # # #   # # # # # # #           # # # # # # # # #                           # #         # 
#                                       #                                                                               # # # # # # #           # # # # # # # # #                                       # 
#                                       #                                       # #                                     # # # # # # #           # # # # # # # # #           # # # #     # # # # #   # # # 
#                                       #                                       # #                                     # # # # # # #               # # # # # # #           # # # #     # # # # #   # # # 
#                                       #                               # # # # # # # # # # # # # # # # # # #           # # # # # # #               # # # # # # #           # # # #     # # # # #   # # # 
#                                       #               # # # # # # # # # # # # # # # # # # # # # # # # # # #                                                                           # # # # #       # 
#                                       #               # # # # # # # # # # # # # # # # # # # # # # # # # # #                                                                                           # 
#                                       #               # # # # # # # # # # # # # # # # # # # # # # # # # # #                                                                         # # #             # 
#                                       #               # # # # # # # # # # # # # # # # # #   # # # # # # # #                                                           # # #         # # #         # # # 
#                                       #                                 # # # # # # # # #   # # # #                                                                   # # #         # # #         # # # 
#                                       #                                                                               # # # # # # #                           #       # # #                 # # # # # # 
# # #                             # # # #                                                                               # # # # # # #                           #                   # # # #   # # # # # # 
# # #                             # # # #                                                                               # # # # # # #                           # # # # # # # #     # # # #   # # # # # # 
# # #                             # # # #                                                                               # # # # # # #                           # # # # # # # #     # # # #   # # # #   # 
# # #                             # # # #                                                                               # # # # # # #                           # # # # # # # #     # # # #             # 
#                                       #                                                                               # # # # # # #                           #     # # # # #                         # 
#                                       #                                                                               # # # # # # #                           #                                       # 
# # # # # # # #           # # # # # # # # # # # # # # # # # # # # # # # # # # # # # # # # # # # # # # # # # # # # # # # # # # # # # # # # # # # # # # # # # # # # # # # # # # # # # # # # # # # # # # # # 
#                                       # # # # # # # #           # # # # # # # #   # # # #                           # # # #                       # # # #     #                                       # 
#                                       # # # # # # # #           # # # # # # # #   # # # #                           # # # #                       # # # #     #                                       # 
#                                       #                           # #         #                                                                               #                                       # 
#                                       #                                       #                                                                               #                                       # 
#                                       #           # # # #     # # # # #   # # #                                                                               #                                       # 
#                                       #           # # # #     # # # # #   # # #                                                                               #                                       # 
#                                       #           # # # #     # # # # #   # # #                                                                               #                                       # 
#                                       #                       # # # # #                                                                                                                               # 
#               # # # #                 #                                                                                                                                         # # #                 # 
#               # # # #                 #                     # # #                                                                                                               # # #                 # 
#               # # # #                 #       # # #         # # #         # #                                                                                                   # # #                 # 
#               # # # #                 #       # # #         # # #         # #                                                                                                                         # 
#               # # # #                 #       # # #                 # # # # # #                                                                               #                                       # 
#               # # # #                 #                   # # # #   # # # # # #                                                                               #                                       # 
#               # # # #                 # # # # # # # #     # # # #   # # # # # #                                                                               #                                       # 
#             # # # # #                 # # # # # # # #     # # # #   # # # #   #                                                                               #                                       # 
#             # # # # #                 # # # # # # # #     # # # #             #   # # # #                           # # # #                       # # # #     #                                       # 
#             # # # # # #               #     # # # # #                         #   # # # #                           # # # #                       # # # #     #                                       # 
#             # # # # # #               #                                       #   # # # #                           # # # #                       # # # #     #                                       # 
#         # # # # # # # #               # # # # # # # #           # # # # # # # # # # # # # # # # # # # # # # # # # # # # # # # # # # # # # # # # # # # # # # # # # # # # # # # # # # # # # # # # # # # # 
#         # # # # # # # #               #                                       #                                       #                                       #                                       # 
#             # # # # # #               #                                       #     # # # #                   # # # # #                                       #     # # # #                   # # # # # 
#             # # # # # #               #                                       #     # # # #                   # # # # #                                       #     # # # #                   # # # # # 
#             # # # # # #               #                                       #     # # # #                   # # # # #                                       #     # # # #                   # # # # # 
#             # # # # # #               #                                       #                                       #                                       #                                       # 
#             # # # # # #               #                                       #             # # # # # #               #                                       #             # # # # # #               # 
#             # # # # #                 #                                       #             # # # # # # #             #                                       #             # # # # # # #             # 
#             # # # # #                                                         #                 # # # # #                                                     #                 # # # # #             # 
#             # # # # #                             # # # # # # # # #           #           # # # # # # # # #                             # # #                 #           # # # # # # # # #           # 
#             # # # # # #                           # # # # # # # # #           #           # # # # # # # # #                             # # #                 #           # # # # # # # # #           # 
#             # # # # # #                           # # # # # # # # #           #         # # # # # # # # # #                             # # #                 #         # # # # # # # # # #           # 
#             # # # # # #                                                       #         # # #   # # # #                                                       #         # # #   # # # #               # 
#             # # # # # #               #                                       #       # # # #   # # # #     # # #     #                                       #       # # # #   # # # #     # # #     # 
#             # # # # # #               #                                       # #     # # #     # # # #     # # #     #                                       # #     # # #     # # # #     # # #     # 
# # # #                                 #                                       # #               # # # #     # # #     #                                       # #               # # # #     # # #     # 
# # # #                                 #                                       # #               # # # #               #                                       # #               # # # #               # 
# # # #                                 #                                       #                 # # # #               #                                       #                 # # # #               # 
# # # #                                 #                                       # # #   # #                 # #         #                                       # # #   # #                 # #         # 
#                                       #                                       # # #   # #                 # #         #                                       # # #   # #                 # #         # 
# # # # # # # #           # # # # # # # # # # # # # # #           # # # # # # # # # # # # # # #           # # # # # # # # # # # # # # # # # # # # # # # # # # # # # # # # # # #           # # # # # # # # 
# # # # # #                       # # # #                                       #                                       #                                       #                                       # 
#   # # # #                       # #   #                                       #                                       #                                       #     # # # #                   # # # # # 
#   # # # #                             #                                       #                                       #                                       #     # # # #                   # # # # # 
#   # # # #                       # # # #                                       #                                       #                                       #     # # # #                   # # # # # 
# # # # # #                       # # # #                                       #                                       #                                       #                                       # 
# # # # # #                             #                                       #                                       #                                       #             # # # # # #               # 
#                                       #                                       #                                       #                                       #             # # # # # # #             # 
#                                                                                                                                                                                 # # # # #             # 
#                                                         # # #                             # # # # # # # # #                                                               # # # # # # # # #           # 
#                                                         # # #                             # # # # # # # # #                                                               # # # # # # # # #           # 
#                                                         # # #                             # # # # # # # # #                                                             # # # # # # # # # #           # 
#                                                                                                                                                                         # # #   # # # #               # 
#                                 # # # #                                       #                                       #                                       #       # # # #   # # # #     # # #     # 
#   # # # # #                     # # # #                                       #                                       #                                       # #     # # #     # # # #     # # #     # 
#   # # # # #                     # # # #                                       #                                       #                                       # #               # # # #     # # #     # 
#   # # # # #                           #                                       #                                       #                                       # #               # # # #               # 
#   # # # #                   # # # #   #                                       #                                       #                                       #                 # # # #               # 
#   # # # #                   # # # #   #                                       #                                       #                                       # # #   # #                 # #         # 
# #   # #                     # # # # # #                                       #                                       #                                       # # #   # #                 # #         # 
# # # # # # # # # # # # # # # # # # # # # # # # # # # # # # # # # # # # # # # # # # # # # # # # # # # # # # # # # # # # # # # # # # # # # # # # # # # # # # # # # # # # # # # # # # # # # # # # # # # # # 
