# # # # # # # # # # # # # # # # # # # # # # # # # # # # # # # # # # # # # # # # # # # # # # # # # # # # # # # # # # # # # # # # # # # # # # # # # # # # # # # # # # # # # # # # # # # # # # # # # # # # # 
#                                       #                                       #                                       #                                       #                                       # 
#                                 #     #                                       #                                       #                                 #     #                                       # 
#   # # # #                   # # # #   #                                       #                                       #   # # # #                   # # # #   # # #                               # # # 
#   # # # #                   # # # #   #                                       #                                       #   # # # #                   # # # #   # # #                               # # # 
#                                 #     #                                       #                                       #                                 #     #                                       # 
#                             #         #                                       #                                       #                             #         #                                       # 
#                                       #                                                     # # # # # # #                                                                                             # 
#                                       #                                                     # # # # # # #                                                                                             # 
#                                       #                                                     # # # # # # #                                                                                             # 
#                                       #               # # # #                               # # # # # # #                                                                                             # 
#                                       #               # # # #                               # # # # # # #                                                                                             # 
#                                       #               #                                     # # # # # # #                                                                                             # 
#                                       #                                                     # # # # # # #                                                                                             # 
#                                       #                                       #                                       #                                       #                                       # 
#                                       #               # # # #                 #                                       #                                       #                                       # 
#                                       #               # # # #                 #                                       #                                       #                                       # 
#                                       #                                       #                                       #                                       #                                       # 
# # #   # #                 # #         #                                       #                                       # # #   # #                 # #         #                                       # 
#                                       #               # # # #                 #                                       #                                       #                                       # 
# # # # # # #               # # # # # # #           # # # # # #                 # # # # # # #               # # # # # # # # # # # # # # # # # # # # # # # # # # # # #                               # #   
#                                       #           # #                         #                                       #                                       # # #                               # # # 
#                                       #                   #                   #                                       #                               #       #                                       # 
#                                       #               # # # #                 #                                       #                                       #                                       # 
#                                       #               # # # #                 #                                       # #                             # #     #                                       # 
#                                       #               # # # #                 #                                       # #                   # #       # #     #                                       # 
#                                       #                                       #                                       # #                             # #     #                                       # 
#                                                                                                                         #       # # #                         #                                       # 
#                                                       # # # #                                                                   # # #                         #                                       # 
#                                                       # # # #                                                                                                 #                                       # 
#                   #                                     # #                                       #                                                           #                                       # 
#                   #                                     # #                                       #                                                           #                                       # 
#                                                         # #                                                                                 #                 #                                       # 
#                                                         # #                                                                                                   #                                       # 
#                                       #                                       #                                       # # #     # # # #                       #                                       # 
#                                       #                                       #                                       # # #                                   # # #                               # # # 
#                                       #                                       #                                       # #                         # #         # # #                               # # # 
#                                       #                                       #                                       # #                         # #         #                                       # 
#                                       #                                       #                                       # #         #           #   # #         #                                       # 
#                                       #                                       #                                       # #         #           #               #                                       # 
# # # # # # # # # # # # # # # # # # # # # # # # # # #               # # # # # # # # # # # # #               # # # # # # # # # # # # #               # # # # # # # # # # # # #               # # # # # # # 
                                    #   #                                       #                                       #                                       #                                       # 
                                    #   #                                 #     #                                       #                                       #                                       # 
                                    #   #   # # # #                   # # # #   #                                       #                                       #                                       # 
                                        #   # # # #                   # # # #   #                                       #                                       #                                       # 
                                        #                                 #     #                                       #                                       #                                       # 
                                        #                             #         #                                       #                                       #                                       # 
              #                         #                                                                               #                                       #                                       # 
              #                         #                                                                               #                                       #                                       # 
              #     # # #               #                                                                               #                 # # #                 #                 # # #                 # 
              #     # # #               #                                                                               #                 # # #                 #                 # # #                 # 
              #     # # #               #                                                                               #                 # # #                 #                 # # #                 # 
              #                         #                                                                               #                   #                   #                   #                   # 
              #                         #                                                                               #                                       #                                       # 
                                        #                                       #                                       #                                       #                                       # 
                                        #                                       #                                       #                                       #                                       # 
                                      # #                                       #                                       #                                       #                                       # 
                                        #                                       #                                       #                                       #                                       # 
                                        # # #   # #                 # #         #                                       #                                       #                                       # 
                                        #                                       #                                       #                                       #                                       # 
# # # # # # #               # # # # # # # # # # # # #               # # # # # # # # # # # # # # # # # # # # # # # # # # # # # # # # # # # # # # # # # # # # # # # # # # # # #               # # # # # # # 
#                                                                               #                                       #                                       #                                       # 
#                                                                               #                                       #                                       #                                       # 
#                                                                               #                                       #                                       #                                       # 
#                                                                               #                                       #                                       #                                       # 
#                                                                               #                                       #                                       #                                       # 
#                                                                               #                                       #                                       #                                       # 
#                                                                                                                       #             # # # # # # #                         # # # # # # # # #           # 
#                                                                                                                       #             # # # # # # #                         # # # # # # # # #           # 
#                                                                                                                       #             # # # # # # #                         # # # # # # # # #           # 
#                                                                                                                       #             # # # # # # #                         # # # # # # # # #           # 
#                                         #                   # #                                                       #             # # # # # # #                         # # # # # # # # #           # 
#                                         #                   # #                                                       #             # # # # # # #                         # # # # # # # # #           # 
#                                         #               # #                                                           #             # # # # # # #                         # # # # # # # # #           # 
#                                                         # # # #               #                                       #                                       #                                       # 
#                                                         # # # #               #                                       #                                       #                                       # 
#                                                         # #                   #                                       #                                       #                                       # 
#                                                                               #                                       #                                       #                                       # 
#                                                                               #                                       #                                       #                                       # 
#                                                                               #                                       #                                       #                                       # 
# # # # # # #               # # # # # # # # # # # # # # # # # # # # # # # # # # # # # # # # #               # # # # # # # # # # # # #               # # # # # # # # # # # # #               # # # # # # # 
#                                       #                                                                               #                                       #                                       # 
#                                 #     #                                                                               #                                       #                                 #     # 
#   # # # #                   # # # #   #                                                                               #                                       #   # # # #                   # # # #   # 
#   # # # #                   # # # #   #                                                                               #                                       #   # # # #                   # # # #   # 
#                                 #     #                                                                               #                                       #                                 #     # 
#                             #         #                                                                               #                                       #                             #         # 
#                                                                       # # # # # # # #                                 #                                                                               # 
#                                                       # # # # # #     # # # # # # # #         # # # # #               #                                                                               # 
#                                                       # # # # # #     # # # # # # # #         # # # # #               #                                                                               # 
#                                                       # # # # # #     # # # # # # # #         # # # # #               #                                                                               # 
#                                                       # # # # # #     # # # # # # # #         # # # # #               #                                                                               # 
#                                                       # # # # # #     # # # # # # # #         # # # # #               #                                                                               # 
#                                                                       # # # # # # # #                                 #                                                                               # 
#                                       #                                                                               #                                       #                                       # 
#                                       #                                                                               #                                       #                                       # 
#                                       #                                                                               #                                       #                                       # 
#                                       #                                                                               #                                       #                                       # 
# # #   # #                 # #         #                                                                               #                                       # # #   # #                 # #         # 
#                                       #                                                                               #                                       #                                       # 
# # # # # # # # # # # # # # # # # # # # # # # # # # # # # # # # # # # # # # # # # # # # # # # # # # # # # # # # # # # # # # # # # # # # # # # # # # # # # # # # # # # # # # # # # # # # # # # # # # # # # 
