# # # # # # # # # # # # # # # # # # # # # # # # # # # # # # # # # # # # # # # # # # # # # # # # # # # # # # # # # # # # # # # # # # # # # # # # # # # # # # # # # # # # # # # # # # # # # # # # # # # # # 
#             # # # # # # # #           # # # # # # # #             # # # # # # #                                       #   # # # #                           # # # #                       # # # #     # 
#             # # # # # # # #           # # # # # # # #             # # # # # # #                                       #   # # # #                           # # # #                       # # # #     # 
#                                       #                           # #         #                                       #                                                                               # 
#                                       #                                       #                                       #                                                                               # 
#                                       #           # # # #     # # # # #   # # #                                       #                                                                               # 
#                                       #           # # # #     # # # # #   # # #                                       #                                                                               # 
#                                       #           # # # #     # # # # #   # # #                                       #                                                                               # 
#                 # # #                                         # # # # #                                                                                                                               # 
#                 # # #                                                                           # # #                                                                                                 # 
#                 # # #                                       # # #                               # # #                                                                                                 # 
#                 # # #                         # # #         # # #         # #                   # # #                                                                                                 # 
#                 # # #                         # # #         # # #         # #                                                                                                                         # 
#                 # # #                 #       # # #                 # # # # # #                                       #                                                                               # 
#                                       #                   # # # #   # # # # # #                                       #                                                                               # 
#                                       # # # # # # # #     # # # #   # # # # # #                                       #                                                                               # 
#                                       # # # # # # # #     # # # #   # # # #   #                                       #                                                                               # 
# # # #                                 # # # # # # # #     # # # #             #                                       #   # # # #                           # # # #                       # # # #     # 
# # # #                                 #     # # # # #                         #                                       #   # # # #                           # # # #                       # # # #     # 
# # # #   # #               # # # #     #                                       #                                       #   # # # #                           # # # #                       # # # #     # 
# # # # # # # #           # # # # # # # # # # # # # # #           # # # # # # # # # # # # # # #           # # # # # # # # # # # # # # #           # # # # # # # # # # # # # # # # # # # # # # # # # # # # 
# # # # # # # #             # # # # # # # #                               # # # #                                       # # # # # # # #             # # # # # # #                                       # 
# # # # # # # #             # # # # # # #   # # # #                       # #   # # #                             # # # # # # # # # # #             # # # # # # #                                       # 
#                           # #         #   # # # #                             # # #                             # # # #                           # #         #                                       # 
#                                       #   # # # #                       # # # # # #                             # # # #                                       #                                       # 
#           # # # #     # # # # #   # # #   # # # #                       # # # #                                 # # # #           # # # #     # # # # #   # # #                                       # 
#           # # # #     # # # # #   # # # # # # # #                             #                                       #           # # # #     # # # # #   # # #                                       # 
#           # # # #     # # # # #   # # #                                       #                                       #           # # # #     # # # # #   # # #                                       # 
#                       # # # # #       #                                                                                                       # # # # #                                               # 
#                                       #                                                                                                                                         # # #                 # 
#                     # # #             #                                                                                                     # # #                               # # #                 # 
#       # # #         # # #         # # #                                                                                       # # #         # # #         # #                   # # #                 # 
#       # # #         # # #         # # #                                                                                       # # #         # # #         # #                                         # 
#       # # #                 # # # # # #                                       #                                       #       # # #                 # # # # # #                                       # 
#                   # # # #   # # # # # #     # # # #                     # # # #                                       #                   # # # #   # # # # # #                                       # 
# # # # # # # #     # # # #   # # # # # #     # # # #                     # # # #                                       # # # # # # # #     # # # #   # # # # # #                                       # 
# # # # # # # #     # # # #   # # # #   #     # # # #                           #                                       # # # # # # # #     # # # #   # # # #   #                                       # 
# # # # # # # #     # # # #             #   # # # #                   # # # #   #                                       # # # # # # # #     # # # #             #                                       # 
#     # # # # #                         #     # # #                   # # # #   #                                       #     # # # # #                         #                                       # 
#                                       # #                           # # # # # # # #                             # # # #                                       #                                       # 
# # # # # # # #           # # # # # # # # # # # # # # #           # # # # # # # # # #                             # # # # # # # # # # # # # # # # # # # # # # # # # # # # # # #           # # # # # # # # 
#                                       #                                       # # #                             # # # # #                               # # # # # # # # # # #             # # # # # # # 
#                             # # #     #       # # #                   # # # # # # #                             # # # #   # # # #                       # #   # # # # # # # #             # # # # # # # 
#                             # # #     #       # # #                   # # # # #                                       #   # # # #                             #                           # #         # 
#     # # #                   # # #     #       # # #                   # # # # #                                       #   # # # #                       # # # #                                       # 
#     # # #   # # # # # # #   # # #     #                                       #                                       #   # # # #                       # # # #           # # # #     # # # # #   # # # 
#             # # # # # # #   # # #     #                 # # # #               #                                       # # # # # #                             #           # # # #     # # # # #   # # # 
#             # # # # # # #   # # #     #             # # # # # # #             #                                       #                                       #           # # # #     # # # # #   # # # 
#             # # # # # # #                               # # # # #                                                                                             #                       # # # # #       # 
#           # # # # # # # #                           # # # # # # # #                                                                                           #                                       # 
#         # # # # # # # # #                           # # # # # # # #                                                                                           #                     # # #             # 
#           # # # # # # # #                       # # # # # # # # # #                                                                                           #       # # #         # # #         # # # 
#             # # # # # # #                       # # #                                                                                                         #       # # #         # # #         # # # 
#             # # # # # # #             #         # # #   # # # #     # # #     #                                       #                                       #       # # #                 # # # # # # 
#             # # # # # # #       # # # # #       # #     # # # #     # # #     # # #                             # # # #     # # # #                     # # # #                   # # # #   # # # # # # 
# # # #       # # # # # # #       # # # # #               # # # #     # # #     # # #                             # # # #     # # # #                     # # # # # # # # # # #     # # # #   # # # # # # 
# # # # #                     # # # # # # #                                     # # #                             # # # #     # # # #                           # # # # # # # #     # # # #   # # # #   # 
# # # # #                     # # # # # #                                       # # #                             # # # #   # # # #                   # # # #   # # # # # # # #     # # # #             # 
# # # #                         # # # # # # #   # #                 # #         #                                       #     # # #                   # # # #   #     # # # # #                         # 
#                               # # # # # # #   # #                 # #         #                                       # #                           # # # # # #                                       # 
# # # # # # # #           # # # # # # # # # # # # # # #           # # # # # # # # # # # # # # #           # # # # # # # # # # # # # # # # # # # # # # # # # # # # # # # # # # # # # # # # # # # # # # # # 
#                                       #                                 # # # #                                       #                                       #                                       # 
#                                       #                                 # # # #                                       #                             # # #     #                                       # 
#                                       #                                   # # #                                       #                             # # #     #                                       # 
#                                       #                                   # # #                                       #     # # #                   # # #     #                                       # 
#                                       #                                       #                                       #     # # #   # # # # # # #   # # #     #                                       # 
#                                       #                                       #                                       #             # # # # # # #   # # #     #                                       # 
#                                       #           # # # # # # # # #           #                                       #             # # # # # # #   # # #     #                                       # 
#                                                   # # # # # # # # #                                                                 # # # # # # #                                                     # 
#                 # # #                             # # # # # # # # #                                                               # # # # # # # #                           # # # # # # # #           # 
#                 # # #                             # # # # # # # # #                               #                             # # # # # # # # #                           # # # # # # # #           # 
#                 # # #                             # # # # # # # # #                               #                               # # # # # # # #                           # # # # # # # #           # 
#                                                   # # # # # # # # #                                                                 # # # # # # #                                                     # 
#                                       #           # # # # # # # # #           #                                       #             # # # # # # #             #                                       # 
#                                       #           # # # # # # # # #           #             # # # # # # # #           #             # # # # # # #       # # # #                                       # 
#                                       #           # # # # # # # # #           #           # # # # # # # # #           # # # #       # # # # # # #       # # # #                                       # 
#                                       # # #                                   #           # # # # # # # # #           # # # # #                     # # # # # #                                       # 
#                                       # # #                                   #           # # # # # # # # #           # # # # #                     # # # # # #                                       # 
#                                       # # # #                                 #           # # # # # # # # #           # # # #                         # # # # #                                       # 
#                                       # # # #                                 #           # # # # # # # # #           #                               # # # # #                                       # 
# # # # # # # #           # # # # # # # # # # # # # # #           # # # # # # # #           # # # # # # # # #           # # # # # # # #           # # # # # # # # # # # # # # #           # # # # # # # # 
# #                           # # # # # #                                       #           # # # # # # # # #           #                                                                               # 
#                             # # # # # #                                       #           # # # # # # # # #           #                                                                               # 
#                             # # # # # #                                       #           # # # # # # # # #           #                                                                               # 
#             # # # # #   # # # # # #   #                                       #             # # # # # # # #           #                                                                               # 
#             # # # # #   # # # # # #   #                                       #                                       #                                                                               # 
#                                       #                                       #                                       #                                                                               # 
#                                       #                                       #                                       #                                                                               # 
#                                                                                                                                                                                                       # 
#                                                                                                                                           # #                 # #                 # #                 # 
#             # #         # #                                                                       #                                       # #                 # #                 # #                 # 
#             # #         # #                                                                       #                                       # #                 # #                 # #                 # 
#                                                                                                                                                                                                       # 
#                                       #                                       #                                       #                                                                               # 
#     # #                               #                                       #                                       #                                                                               # 
#     # #                               #                                       #                                       #                                                                               # 
#     # #     # # # # #   # #           #                                       #                                       #                                                                               # 
#     # #     # #         # #           #                                       #                                       #                                                                               # 
#                                       #                                       #                                       #                                                                               # 
# #                                   # #                                       #                                       #                                                                               # 
# # # # # # # # # # # # # # # # # # # # # # # # # # # # # # # # # # # # # # # # # # # # # # # # # # # # # # # # # # # # # # # # # # # # # # # # # # # # # # # # # # # # # # # # # # # # # # # # # # # # # 
