# # # # # # # # # # # # # # # # # # # # # # # # # # # # # # # # # # # # # # # # # # # # # # # # # # # # # # # # # # # # # # # # # # # # # # # # # # # # # # # # # # # # # # # # # # # # # # # # # # # # # 
# #         #                         # #       # # # #           # # # #       # #         #                         # #                                                                               # 
#   # # # # #                     #     #       # # # #           # # # #       #   # # # # #                     #     #                                                                               # 
#   # # # # #               # # # # #   #       # # # #           # # # #       #   # # # # #               # # # # #   #                                                                               # 
#   # # # # #               # # # # #   #       # # # #           # # # #       #   # # # # #               # # # # #   #                                                                               # 
#   # # # # #               # # # # #   #       # # # #           # # # #       #   # # # # #               # # # # #   #                                                                               # 
#                           # # #       # # # # # # # #           # # # # # # # #                           # # #       #                             # # # # # # # # #                                 # 
#                                       #                                       #                                       #                           # # # # # # # # # # #                               # 
#                                                                                                                                                   # # # # # # # # # # #                               # 
#                                                                                                                                                   # # # # # # # # # # #                               # 
#                                                                                                                                           # #     # # # # # # # # # # #           # #                 # 
#                                                                                                                                                   # # # # # # # # # # #                               # 
#                                         # # # # #                                                                                                 # # # # # # # # # # #                               # 
#                                       # # # # # #                             #                                       #                           # # # # # # # # # # #                               # 
#                                       # # # # # # # #                         #                                       #                           # # # # # # # # # # #                               # 
#                                 # # # # # # # # # # #                         #                                 # # # #                                                                               # 
#                                 # # # # # # # # # # #                         #                                 # # # #                                                                               # 
# # #   # #                 # #   # # # # # # # # # # #                         # # #   # #                 # #   # # # #                                                                               # 
# # #   # #                 # #   # # # #       # # # #                         # # #   # #                 # #   # # # #                                                                               # 
# #     # #                 # #       # #       # # # #                         # #     # #                 # #       # #                                                                               # 
# # # # # # # #           # # # # # # # # # # # # # # # # # # # # # # # # # # # # # # # # # # #           # # # # # # # # # # # # # # # # # # # # # # # # # # # # # # # # # # #           # # # # # # # # 
#   # # #                             # # # #                       # # # #     #                                       # # #                         # # #     #                                       # 
#   # # #                             # # # #                       # # # #     #                                       # # #                         # # #     #                                       # 
#                                                                               #                                       # # #                         # # # #   #                                       # 
#                                                                               #                                       # # #                 # # #   # # # #   #                                       # 
#                                                                               #                                       # # #                 # # #   # # # #   #                                       # 
#                                                                               #                                       # # #     # # #       # # #   # # # #   #                                       # 
#                                                                               #                                       # # #     # # #               # # # #   #                                       # 
#                                                                               #               # # # #                           # # #                         #                                       # 
#                                                                               #               # # # #                           # # #                         #                   # #                 # 
#                                                                               #               # # # #                                             # # # #     #                   # #                 # 
#                                                                               #               # # # #                                     # # #   # # # #     #                   # #                 # 
#                                                                               #               # # # #                           # # # #   # # #   # # # #     #                                       # 
#                                                                               #               # # # #                 #         # # # #   # # #   # # # #     #                                       # 
#                                                                               #               # # # #                 # # # #   # # # #                       #                                       # 
#                                                                               #               # # # #                 # # # #   # # # #         # # # #       #                                       # 
#                                                                               #             # # # # #                 # # #     # # # #         # # # #       #                                       # 
#   # # # #                           # # # #                       # # # #     #             # # # # #                 # # #                     # # # #       #                                       # 
#   # # # #                           # # # #                       # # # #     #             # # # # # #               # # #     # # #       # # # # # #       #                                       # 
# # # # # # # # #                     # # # #                       # # # #     #             # # # # # #               # # #     # # #       # # # # #         #                                       # 
# # # # # # # # #         # # # # # # # # # # # # # # # # # # # # # # # # # # # #         # # # # # # # #               # # # # # # # #           # # # # # # # # # # # # # # #           # # # # # # # # 
# # # # # # # # #                 # # # #       # # # #           # # # #       #         # # # # # # # #               # #         #                         # #                           # # #   # # # 
# # # # # # # # #                 # # # #       # # # #           # # # #       #             # # # # # #               #   # # # # #                     #     #                                   # # # 
# # # # # # # # #                 # # # #       # # # #           # # # #       #             # # # # # #               #   # # # # #               # # # # #   #                                       # 
# # # # # # # # #                       #       # # # #           # # # #       #             # # # # # #               #   # # # # #               # # # # #   #   # # #                           # # # 
# # # # # # # # #                     # #       # # # #           # # # #       #             # # # # # #               #   # # # # #               # # # # #   #   # # #             # # # #       # # # 
# # # # # # # # #                     # # # # # # # # #           # # # # # # # #             # #                       #                           # # #       #   # # #             # # # #           # 
# # # # # # # # #                       #                                       #             # # # # # #               #                                       #             #   # # # # #             # 
# # # # # # # # # # # # #                                                       #             # # # # # #               #                                       #             #   # # #                 # 
# # # # # # # # # # # # # #                                                     #             # # # # # #               #                                       #           # # # # # #   # # #         # 
# # # # # # # # # # # # # #                                                     #             # # # # # #               #                                       #           # # # # # #   # # #         # 
# # # # # # # # # # # # #                                                       #             # # # # #                 #                                       #           # # # # # #   # # #         # 
# # # # # # # # # # # # #                 # # # # #                             #             # # # # #                 #                                       #           # # # # # #   # # #         # 
# # # # # # # # #                       # # # # # #                             #             # # # # #                 #                                       #             # # # # #                 # 
# # # # # # # # #                     # # # # # # # # #                         #             # # # # #                 #                                       #                 # # #             # # # 
# # # # # # # # #                     # # # # # # # # #                         #                                       #                                 # # # #                         # # #     # # # 
# # # # # # # # #                     # # # # # # # # #                         # # # #                                 #                                 # # # #   # # #                 # # #         # 
# # # # # # # # #                     # # # # # # # # #                         # # # #                                 # # #   # #                 # #   # # # #   # # #                 # # #         # 
# # # # # # # # #                       #       # # # #                         # # # #                                 # # #   # #                 # #   # # # #   # # #                               # 
# # # # # # # # #                       #       # # # #                         #                                       # #     # #                 # #       # #   # # #                               # 
# # # # # # # # #         # # # # # # # # # # # # # # #           # # # # # # # # # # # # # # # # # # # # # # # # # # # # # # # # # # #           # # # # # # # # # # # # # # # # # # # # # # # # # # # # 
# # # # # # # # #                       #                                       #                                       #       # # # #           # # # #       #                                       # 
# #                                   # # #                                   # #                                       #       # # # #           # # # #       #                                       # 
# #                                     # #                                     #                                       #       # # # #           # # # #       #                                       # 
#                                       #                                       #                                       #       # # # #           # # # #       #                                       # 
#                                       #                                       #                                       #       # # # #           # # # #       #                                       # 
#                                       #                                       #                                       # # # # # # # #           # # # # # # # #                                       # 
#                                       #                                       #                                       #                                       #                                       # 
#                                       #                                       #                                                                                                                       # 
#                 # # #                 #                 # # #                 #                                                                                                   # #                 # 
#                 # # #                 #                 # # #                 #                 # # #                                                                             # #                 # 
#                 # # #                 #                 # # #                 #                 # # #                                                                             # #                 # 
#                   #                   #                   #                   #                                         # # # # #                                                                     # 
#                   #                   #                   #                   #                                       # # # # # #                             #                                       # 
#                                       #                                       #         # # # # # # # # # # #         # # # # # # # #                         #                                       # 
#                                       #                                       #         # # # # # # # # # # #         # # # # # # # #                         #                                       # 
#                                       #                                       #         # # # # # # # # # # #         # # # # # # # #                         #                                       # 
# #                                   # # #                                   # #         # # # # # # # # # # #         # # # # # # # #                         #                                       # 
#                                       #                                       #         # # # # # # # # # # #         #       # # # #                         #                                       # 
#                                       #                                       #         # # # # # # # # # # #         #       # # # #                         #                                       # 
# # # # # # # # # # # # # # # # # # # # # # # # # # # #           # # # # # # # #         # # # # # # # # # # #         # # # # # # # #           # # # # # # # # # # # # # # # # # # # # # # # # # # # # 
#                                       #       # # # #           # # # #       #         # # # # # # # # # # #         #       # # # #           # # # #       #                                       # 
#                                       #       # # # #           # # # #       #         # # # # # # # # # # #         #       # # # #           # # # #       #                                       # 
#                                       #       # # # #           # # # #       #         # # # # # # # # # # #         #       # # # #           # # # #       #                                       # 
#                                       #       # # # #           # # # #       #         # # # # # # # # # # #         #       # # # #           # # # #       #                                       # 
#                                       #       # # # #           # # # #       #         # # # # # # # # # # #         #       # # # #           # # # #       #                                       # 
#                                       # # # # # # # #           # # # # # # # #                                       # # # # # # # #           # # # # # # # #                                       # 
#                                       #                                       #                                       #                                       #                                       # 
#                                                                               #                                                                                                                       # 
#                 # # #                                                         #                                                                                                   # #                 # 
#                 # # #                                                         #                 # # #                                                                             # #                 # 
#                 # # #                                                         #                 # # #                                                                             # #                 # 
#                                         # # # # #                             #                                         # # # # #                                                                     # 
#                                       # # # # # #                             #                                       # # # # # #                             #                                       # 
#                                       # # # # # # # #                         #                                       # # # # # # # #                         #                                       # 
#                                       # # # # # # # #                         #                                       # # # # # # # #                         #                                       # 
#                                       # # # # # # # #                         #                                       # # # # # # # #                         #                                       # 
#                                       # # # # # # # #                         #                                       # # # # # # # #                         #                                       # 
#                                       #       # # # #                         #                                       #       # # # #                         #                                       # 
#                                       #       # # # #                         #                                       #       # # # #                         #                                       # 
# # # # # # # # # # # # # # # # # # # # # # # # # # # # # # # # # # # # # # # # # # # # # # # # # # # # # # # # # # # # # # # # # # # # # # # # # # # # # # # # # # # # # # # # # # # # # # # # # # # # # 
