# # # # # # # # # # # # # # # # # # # # # # # # # # # # # # # # # # # # # # # # # # # # # # # # # # # # # # # # # # # # # # # # # # # # # # # # # # # # # # # # # # # # # # # # # # # # # # # # # # # # # 
# #         #                         # #                                       #                                       # #         #                         # # # #                         # # #     # 
#   # # # # #                     #     # # #                             # # # #                                       #   # # # # #                     #     # # #                         # # #     # 
#   # # # # #               # # # # #   # # #                             # # # #                                       #   # # # # #               # # # # #   # # #                         # # # #   # 
#   # # # # #               # # # # #   # # #                             # # # #                                       #   # # # # #               # # # # #   # # #                 # # #   # # # #   # 
#   # # # # #               # # # # #   # # #                             # # # #                                       #   # # # # #               # # # # #   # # #                 # # #   # # # #   # 
#                           # # #       #                                       #                                       #                           # # #       # # #     # # #       # # #   # # # #   # 
#                                       #                                       #                                       #                                       # # #     # # #               # # # #   # 
#                                                                               #                                                                                         # # #                         # 
#                                                                               #                   # #                                                                   # # #                         # 
#                                                                               #                   # #                                                                                     # # # #     # 
#                                                                               #                   # #                                                                             # # #   # # # #     # 
#                                                                               #                                                                                         # # # #   # # #   # # # #     # 
#                                       #                                       #                                       #                                       #         # # # #   # # #   # # # #     # 
#                                       #                                       #                                       #                                       # # # #   # # # #                       # 
#                                 # # # #                                       #                                       #                                 # # # # # # #   # # # #         # # # #       # 
#                                 # # # #                                       #                                       #                                 # # # # # #     # # # #         # # # #       # 
# # #   # #                 # #   # # # #                                       #                                       # # #   # #                 # #   # # # # # #                     # # # #       # 
# # #   # #                 # #   # # # #                                       #                                       # # #   # #                 # #   # # # # # #     # # #       # # # # # #       # 
# #     # #                 # #       # # # #                             # # # #                                       # #     # #                 # #       # # # #     # # #       # # # # #         # 
# # # # # # # #           # # # # # # # # # #                             # # # # # # # # # # #           # # # # # # # # # # # # # # # # # # # # # # # # # # # # # # # # # # #           # # # # # # # # 
#       # # # #           # # # #       # # #                             # # # # #         #                         # # # #                         # # #     #                                       # 
#       # # # #           # # # #       # # #                             # # # #   # # # # #                     #     # # #                         # # #     # #                                   # # 
#       # # # #           # # # #       #                                       #   # # # # #               # # # # #   # # #                         # # # #   # #                                     # 
#       # # # #           # # # #       #                                       #   # # # # #               # # # # #   # # #                 # # #   # # # #   #                                       # 
#       # # # #           # # # #       #                                       #   # # # # #               # # # # #   # # #                 # # #   # # # #   #                                       # 
# # # # # # # #           # # # # # # # #                                       #                           # # #       # # #     # # #       # # #   # # # #   #                                       # 
#                                       #                                       #                                       # # #     # # #               # # # #   #                                       # 
#                                                                                                                                 # # #                         #                                       # 
#                                                                                                                                 # # #                         #                 # # #                 # 
#                                                                                                                                                   # # # #     #                 # # #                 # 
#                                                                                                                                           # # #   # # # #     #                 # # #                 # 
# # # # # #                                                                                                                       # # # #   # # #   # # # #     #                   #                   # 
# # # # # #                             #                                       #                                       #         # # # #   # # #   # # # #     #                   #                   # 
# # # # # # # #                         # # #                             # # # #                                       # # # #   # # # #                       #                                       # 
# # # # # # # #                         # # #                             # # # #                                 # # # # # # #   # # # #         # # # #       #                                       # 
# # # # # # # #                         # # #                             # # # #                                 # # # # # #     # # # #         # # # #       #                                       # 
# # # # # # # #                         # # #                             # # # # # #   # #                 # #   # # # # # #                     # # # #       # #                                   # # 
#       # # # #                         #                                       # # #   # #                 # #   # # # # # #     # # #       # # # # # #       #                                       # 
# # # # # # # # #                       #                                       # #     # #                 # #       # # # #     # # #       # # # # #         #                                       # 
# # # # # # # # #         # # # # # # # # # # # # # # #           # # # # # # # # # # # # # # #           # # # # # # # # # # # # # # # # # # # # # # # # # # # # # # # # # # #           # # # # # # # # 
# # # # # # # # #                 # # # #   # # #                             # # # #                       # # # #     #                                       #                                       # 
# # # # # # # # #                 # # # #   # # #                             # # # #                       # # # #     #                                       #                                       # 
# # # # # # # # #                 # # # #                                                                               #                                       #                                       # 
# # # # # # # # #                       #                                                                               #                                       #                                       # 
# # # # # # # # #                     # #                                                                               #                                       #                                       # 
# # # # # # # # #                     # #                                                                               #                                       #                                       # 
# # # # # # # # #                       #                                                                               #                                       #                                       # 
# # # # # # # # # # # # #               #                                                                               #                                                                               # 
# # # # # # # # # # # # # #             #                                                                               #                 # # #                                     # #                 # 
# # # # # # # # # # # # # #             #                                                                               #                 # # #                                     # #                 # 
# # # # # # # # # # # # #               #                                                                               #                 # # #                                     # #                 # 
# # # # # # # # # # # # #               #                                                                               #                                                                               # 
# # # # # # # # #                       #                                                                               #                                       #                                       # 
# # # # # # # # #                     # #                                                                               #                                       #                                       # 
# # # # # # # # #                     # #                                                                               #                                       #                                       # 
# # # # # # # # #                     # #                                                                               #                                       #                                       # 
# # # # # # # # #                     # #   # # # #                           # # # #                       # # # #     #                                       #                                       # 
# # # # # # # # #                       #   # # # #                           # # # #                       # # # #     #                                       #                                       # 
# # # # # # # # #                       #   # # # #                           # # # #                       # # # #     #                                       #                                       # 
# # # # # # # # #         # # # # # # # # # # # # # # #           # # # # # # # # # # # # # # #           # # # # # # # # # # # # # # #           # # # # # # # # # # # # # # #           # # # # # # # # 
# # # # # # # # #                       #                                       # #                                                                           # # #         #                         # # 
#                                       #                                       #                                                                               #   # # # # #                     #     # 
#                                       #                                       #                                                                               #   # # # # #               # # # # #   # 
#                                       #                                       #                                                                               #   # # # # #               # # # # #   # 
#                                       #                                       #                                                                               #   # # # # #               # # # # #   # 
#                                       #                                       #                                                                               #                           # # #       # 
#                                       #                                       #                                                                               #                                       # 
#                                                                                                                                                                                                       # 
#                                                           # #                                                                                                                                         # 
#                 # # #                                     # #                                                                             # # # #                                                     # 
#                 # # #                                     # #                                                         # # # #             # # # #                                                     # 
#                                                                                                                       # # # #         # # # # # #                                                     # 
#                                       #                                       #                                       # # # #         # # # # # #             #                                       # 
#         # # # # # # # # # # #         #                                       #                                                       # # # # # #             #                                       # 
#         # # # # # # # # # # #         #                                       #                                                       # # # # # #             #                                 # # # # 
#         # # # # # # # # # # #         #                                       #                                                         # # # # #             #                                 # # # # 
#         # # # # # # # # # # #         #                                       #                                                                               # # #   # #                 # #   # # # # 
#         # # # # # # # # # # #         #                                       #                                                                               # # #   # #                 # #   # # # # 
#         # # # # # # # # # # #         #                                       # #                                                                           # # #     # #                 # #       # # 
#         # # # # # # # # # # #         # # # # # # # #           # # # # # # # # # # # # # # #           # # # # # # # # # # # # # # #           # # # # # # # # # # # # # # # # # # # # # # # # # # # # 
#         # # # # # # # # # # #         # #         #                         # # # #                         # # #     #                                       #                           # # #   # # # 
#         # # # # # # # # # # #         #   # # # # #                     #     # # #                         # # #     #                                       #                                   # # # 
#         # # # # # # # # # # #         #   # # # # #               # # # # #   # # #                         # # # #   #                                       #                                       # 
#         # # # # # # # # # # #         #   # # # # #               # # # # #   # # #                 # # #   # # # #   #                                       #   # # #                           # # # 
#         # # # # # # # # # # #         #   # # # # #               # # # # #   # # #                 # # #   # # # #   #                                       #   # # #             # # # #       # # # 
#                                       #                           # # #       # # #     # # #       # # #   # # # #   #                                       #   # # #             # # # #           # 
#                                       #                                       # # #     # # #               # # # #   #                 # # #                 #             #   # # # # #             # 
#                                       #                                       #         # # #                                           # # #                               #   # # #                 # 
#                                       #                                       #         # # #                                           # # #                             # # # # # #   # # #         # 
#                 # # #                 #                                       #                           # # # #                       # # #                             # # # # # #   # # #         # 
#                 # # #                 #                                       #                   # # #   # # # #                       # # #                             # # # # # #   # # #         # 
#                                       #                                       #         # # # #   # # #   # # # #                       # # #                             # # # # # #   # # #         # 
#                                       #                                       #         # # # #   # # #   # # # #     #                 # # #                 #             # # # # #                 # 
#                                       #                                       # # # #   # # # #                       #                 # # #                 #                 # # #             # # # 
#                                       #                                 # # # # # # #   # # # #         # # # #       #                                       #                         # # #     # # # 
#                                       #                                 # # # # # #     # # # #         # # # #       #                                       #   # # #                 # # #         # 
#                                       # # #   # #                 # #   # # # # # #                     # # # #       #                                       #   # # #                 # # #         # 
#                                       # # #   # #                 # #   # # # # # #     # # #       # # # # # #       #                                       #   # # #                               # 
#                                       # #     # #                 # #       # # # #     # # #       # # # # #         #                                       #   # # #                               # 
# # # # # # # # # # # # # # # # # # # # # # # # # # # # # # # # # # # # # # # # # # # # # # # # # # # # # # # # # # # # # # # # # # # # # # # # # # # # # # # # # # # # # # # # # # # # # # # # # # # # # 
