# # # # # # # # # # # # # # # # # # # # # # # # # # # # # # # # # # # # # # # # # # # # # # # # # # # # # # # # # # # # # # # # # # # # # # # # # # # # # # # # # # # # # # # # # # # # # # # # # # # # # 
#         # # #                 # # #   #                                       #                                       #                         # # # # # # # #                                       # 
#   # # # # # #                 # # #   #         # #               # # # # #   #                                       #                 # # # # # # # # # # # #                                       # 
#   # # # # # #               # # # #   #         # #               # # # # #   #                                       #                 # # # # # # # # # # # #                                       # 
#   # # #                     # # # #   #         # #               # # # # #   #                                       #                 # # # # # # # # # # # #                                       # 
#                           # # # # #   #     #                           # #   #                                       #                 # # # # # # # # # # # #                                       # 
#                           # # # # #   #     #                           # #   #                 # # #                 #                 # # # # # # # # #     #                                       # 
#                           # # #       #                                                       # # # # #               #         # #     # # # # # # #                                                 # 
#                                       #                                                       # # # # #               #         # #     # # # # # # #                                                 # 
#                                       #                                                       # # # # #               #       # # #   # # # # # # # #                           # # #                 # 
#                                       #                                                       # # # # #               #       # # #   # # # # # # # #                           # # #                 # 
#                                       #                                                       # # # # #               #       # # #   # # # # # # # # # #                       # # #                 # 
#                                       #                                                       # # # # #               #               # # # # # # # # # #                       # # #                 # 
#                                       #                                                       # # # # #               #               # # # # # # #                             # # #                 # 
#                                       #   # # #                               #                 # # #                 #           # # # # # # # # #           #                                       # 
#                                       #   # # #                               #                                       #     # # # # # # # # # # # #           #                                       # 
# # #                                   #   # # # # #                           #                                       #     # # # # # # # # # # # # # #       #                                       # 
# # # #                                 #   # # # # #                           #                                       #     # # # # # # # # # # # # # #       #                                       # 
# # # #                                 #   # # # # #                           #                                       #     # # # # # # # # # # # # # #       #                                       # 
# # # #                                 #                                       #                                       #     # # # # # # # # # # # # # #       #                                       # 
# # # # # # #               # # # # # # # # # # # # #               # # # # # # # # # # # # #               # # # # # # # # # # # # # # # # # # # # # # # # # # # # # # # # #               # # # # # # # 
#                                       #                                       #                                       #     # # # # # # # # # # # # # #                                               # 
#         # #               # # # # #   #                                       #                                       #                                                                               # 
#         # #               # # # # #   #                                       #                                       #                       # # # # # # # # # # # # # # # #                         # 
#         # #               # # # # #   #                                       #                                       #                       # # # # # # # # # # # # # # # #                         # 
#     #                           # #   #                                       #                                       # # #                   # # # # # # # # # # # # # # # #                         # 
#     #                           # #   #                                       #                                       # # #                   # # # # # # # # # # # # # # # #                         # 
#                                                                                                                                               # # # # # # # # # # # # # # # #                         # 
#                                                                                                                                               # # # # # # # # # # # # # # # #                         # 
#                                                                                                                                               # # # # # # # # # # # # # # # #                         # 
#                                                                                                                                           # # # # # # # # # # # # # # # # # #     # #                 # 
#                                                                                                                                               # # # # # # # # # # # # # # # #                         # 
#                                                                                                                                               # # # # # # # # # # # # # # # #                         # 
#                                                                                                                                               # # # # # # # # # # # # # # # #                         # 
#   # # #                               #                                       #                                       #                       # # # # # # # # # # # # # # # #                         # 
#   # # #                               #                                       #                                       #                       # # # # # # # # # # # # # # # #                         # 
#   # # # # #                           #                                       #                                       #                       # # # # # # # # # # # # # # # #                         # 
#   # # # # #                           #                                       #                                       #                       # # # # # # # # # # # # # # # #                         # 
#   # # # # #                           #                                       #                                       #                                                                               # 
#                                       #                                       #                                       #                                                                               # 
# # # # # # #               # # # # # # # # # # # # #               # # # # # # # # # # # # # # # # # # # # # # # # # # # # # # # # #               # # # # # # # # # # # # #               # # # # # # # 
#                                       #                                       #                                       #                                       #         # # #                 # # #   # 
#         # #               # # # # #   #                                       #                                       #                                       #   # # # # # #                 # # #   # 
#         # #               # # # # #   #                                       #                                       #                                       #   # # # # # #               # # # #   # 
#         # #               # # # # #   #                                       #                                       #                                       #   # # #                     # # # #   # 
#     #                           # #   #                                       #                                       #                                       #                           # # # # #   # 
#     #                           # #   #                 # # #                 #                                       #                                       #                           # # # # #   # 
#                                                       # # # # #                                                       #                                       #                           # # #       # 
#                                                       # # # # #                                                       #                                       #                                       # 
#                                                       # # # # #                                                       #                                       #                                       # 
#                                                       # # # # #                                                       #                 # # #                 #                                       # 
#                                                       # # # # #                                                       #                 # # #                 #                                       # 
#                                                       # # # # #                                                       #                 # # #                 #                                       # 
#                                                       # # # # #                                                       #                                       #                                       # 
#   # # #                               #                 # # #                 #                                       #                                       #                                       # 
#   # # #                               #                                       #                                       #                                       #                                       # 
#   # # # # #                           #                                       #                                       #                                     # # # #                                   # 
#   # # # # #                           #                                       #                                       #                                     # # # # #                                 # 
#   # # # # #                           #                                       #                                       #                                     # # # # #                                 # 
#                                       #                                       #                                       #                   # # # # #         # # # # #                                 # 
# # # # # # # # # # # # # # # # # # # # # # # # # # #               # # # # # # # # # # # # #               # # # # # # #                   # # # # #         # # # # # # # #               # # # # # # # 
                                  # # # #         # # #                 # # #   #         # # #                 # # #   #                   # # # # #           #                                       # 
                                  # # # #   # # # # # #                 # # #   #   # # # # # #                 # # #   #                   # # # # #           #         # #               # # # # #   # 
                                  # # # #   # # # # # #               # # # #   #   # # # # # #               # # # #   #                   # # # # #           #         # #               # # # # #   # 
                                  # # # #   # # #                     # # # #   #   # # #                     # # # #   #               # # # # # # # # # # #   #         # #               # # # # #   # 
                                        #                           # # # # #   #                           # # # # #   #               # # # # # # # # # # # # #     #                           # #   # 
                                        #                           # # # # #   #                           # # # # #   #               # # # # # # # # # # # # #     #                           # #   # 
              #                                                     # # #                                   # # #                     # # # # # # # # # # # # # #                                       # 
              #                                                                                                                       # # # # # # # # # # # # # #                                       # 
# #           #     # # # #                                                                                                           # # # # # # # # # # # # # #                                       # 
# #           #     # # # #                                                                                                         # # # # # # # # # # # # # # #                                       # 
# #           #     # #                                                                                                             # # # # # # # # # # # # # # #                                       # 
              #                                                                                                                     # # # # # # # # # # # # # # #                                       # 
              #                                                                                                                       # # # # # # # # # # # # # #                                       # 
                                        #                                       #                                       #             # # # # # # # # # # # # # #   # # #                               # 
                                        #                                       #                                       #             # # # # # # # # # # # # # #   # # #                               # 
                                    # # # # #                                 # # # #                                   #             # # # # # # # # # # # # # #   # # # # #                           # 
                                    # # # # # #                               # # # # #                                 #             # # # # # # # # # # # # # #   # # # # #                           # 
                                    # # # # # #                               # # # # #                                 #                                       #   # # # # #                           # 
                                      # # # # #                               # # # # #                                 #                                       #                                       # 
# # # # # # # # # # # # # # # # # # # # # # # # # # #               # # # # # # # # # # # # #               # # # # # # # # # # # # # # # # # # # # # # # # # # # # # # # # #               # # # # # # # 
#                                                                               #                                       #                                                                               # 
#                                                                               #                                       #                                                                               # 
#                                                                               #                                       #                                                                               # 
#                                                                               #                                       #                                                                               # 
#                                                                               #                                       #                                                                               # 
#                                                           # # #               #                                       #                                                           # # #               # 
#                                                     # # # # # # # # # # #     #                                                                                             # # # # # # # # # # #     # 
#                                               # # # # # # # # # # # # # #     #                                                                                       # # # # # # # # # # # # # #     # 
#                   # # #                       # # # # # # # # # # # # # #     #                                                           # # #                       # # # # # # # # # # # # # #     # 
#                   # # #             # # # # # # # # # # # # # # # # # # #     #                                                           # # #             # # # # # # # # # # # # # # # # # # #     # 
#                   # # #             # # # # # # # # # # # # # # # # # # #     #                                                           # # #             # # # # # # # # # # # # # # # # # # #     # 
#                                     # # # # # # # # # # # # # # # # # # #     #                                                                             # # # # # # # # # # # # # # # # # # #     # 
#                                     # # # # # # # # # # # # # # # # # # #     #                                                                             # # # # # # # # # # # # # # # # # # #     # 
#                                               # # # # # # # # # # # # # #     #                                       #                                               # # # # # # # # # # # # # #     # 
#                                               # # # # # # # # # # # # # #     #                                       #                                               # # # # # # # # # # # # # #     # 
#                                               # # # # # # # # # # # # # #     #                                       #                                               # # # # # # # # # # # # # #     # 
#                                               # # # # # # # # # # # # # #     #                                       #                                               # # # # # # # # # # # # # #     # 
#                                               # # # # # # # # # # # # # #     #                                       #                                               # # # # # # # # # # # # # #     # 
#                                                   # # # # # # # # # # # #     #                                       #                                                   # # # # # # # # # # # #     # 
# # # # # # # # # # # # # # # # # # # # # # # # # # # # # # # # # # # # # # # # # # # # # # # # # # # # # # # # # # # # # # # # # # # # # # # # # # # # # # # # # # # # # # # # # # # # # # # # # # # # # 
